"GeographyCode","KS604EW0001","KS604EW0002","KS604EW0003","KS604EW0004","KS604EW0005","KS604EW0006","KS604EW0007","KS604EW0008","KS604EW0009","KS604EW0010","KS604EW0011","KS604EW0012","KS604EW0013","KS604EW0014","KS604EW0015","KS604EW0016","KS604EW0017","KS604EW0018","KS604EW0019","KS604EW0020","KS604EW0021","KS604EW0022","KS604EW0023","KS604EW0024","KS604EW0025","KS604EW0026","KS604EW0027","KS604EW0028","KS604EW0029"
"E00021141",88,11,27,39,11,47,6,14,20,7,41,5,13,19,4,12.5,30.6818181818182,44.3181818181818,12.5,53.4090909090909,6.81818181818182,15.9090909090909,22.7272727272727,7.95454545454545,46.5909090909091,5.68181818181818,14.7727272727273,21.5909090909091,4.54545454545455
"E00021143",145,11,27,92,15,84,8,14,52,10,61,3,13,40,5,7.58620689655172,18.6206896551724,63.448275862069,10.3448275862069,57.9310344827586,5.51724137931035,9.6551724137931,35.8620689655172,6.89655172413793,42.0689655172414,2.06896551724138,8.96551724137931,27.5862068965517,3.44827586206897
"E00021145",140,8,25,89,18,69,1,8,47,13,71,7,17,42,5,5.71428571428571,17.8571428571429,63.5714285714286,12.8571428571429,49.2857142857143,0.714285714285714,5.71428571428571,33.5714285714286,9.28571428571429,50.7142857142857,5,12.1428571428571,30,3.57142857142857
"E00021146",253,47,25,131,50,139,19,11,78,31,114,28,14,53,19,18.5770750988142,9.88142292490119,51.7786561264822,19.7628458498024,54.9407114624506,7.5098814229249,4.34782608695652,30.8300395256917,12.2529644268775,45.0592885375494,11.0671936758893,5.53359683794466,20.9486166007905,7.5098814229249
"E00021147",104,6,18,69,11,58,4,9,38,7,46,2,9,31,4,5.76923076923077,17.3076923076923,66.3461538461538,10.5769230769231,55.7692307692308,3.84615384615385,8.65384615384615,36.5384615384615,6.73076923076923,44.2307692307692,1.92307692307692,8.65384615384615,29.8076923076923,3.84615384615385
"E00021148",137,10,18,87,22,69,6,10,40,13,68,4,8,47,9,7.2992700729927,13.1386861313869,63.5036496350365,16.0583941605839,50.3649635036496,4.37956204379562,7.2992700729927,29.1970802919708,9.48905109489051,49.6350364963504,2.91970802919708,5.83941605839416,34.3065693430657,6.56934306569343
"E00021149",116,10,25,62,19,65,2,17,36,10,51,8,8,26,9,8.62068965517241,21.551724137931,53.448275862069,16.3793103448276,56.0344827586207,1.72413793103448,14.6551724137931,31.0344827586207,8.62068965517241,43.9655172413793,6.89655172413793,6.89655172413793,22.4137931034483,7.75862068965517
"E00021150",131,6,31,81,13,69,2,10,46,11,62,4,21,35,2,4.58015267175572,23.6641221374046,61.8320610687023,9.9236641221374,52.6717557251908,1.52671755725191,7.63358778625954,35.1145038167939,8.3969465648855,47.3282442748092,3.05343511450382,16.030534351145,26.7175572519084,1.52671755725191
"E00021151",91,13,28,44,6,50,8,14,25,3,41,5,14,19,3,14.2857142857143,30.7692307692308,48.3516483516484,6.59340659340659,54.9450549450549,8.79120879120879,15.3846153846154,27.4725274725275,3.2967032967033,45.0549450549451,5.49450549450549,15.3846153846154,20.8791208791209,3.2967032967033
"E00021152",131,11,38,77,5,64,2,22,38,2,67,9,16,39,3,8.3969465648855,29.0076335877863,58.7786259541985,3.81679389312977,48.8549618320611,1.52671755725191,16.793893129771,29.0076335877863,1.52671755725191,51.1450381679389,6.87022900763359,12.2137404580153,29.7709923664122,2.29007633587786
"E00021153",269,19,20,161,69,131,8,6,78,39,138,11,14,83,30,7.0631970260223,7.43494423791822,59.8513011152416,25.6505576208178,48.6988847583643,2.97397769516729,2.23048327137546,28.996282527881,14.4981412639405,51.3011152416357,4.08921933085502,5.20446096654275,30.8550185873606,11.1524163568773
"E00021154",125,21,35,56,13,63,9,18,30,6,62,12,17,26,7,16.8,28,44.8,10.4,50.4,7.2,14.4,24,4.8,49.6,9.6,13.6,20.8,5.6
"E00021155",278,21,30,176,51,150,13,19,90,28,128,8,11,86,23,7.55395683453237,10.7913669064748,63.3093525179856,18.3453237410072,53.9568345323741,4.67625899280576,6.83453237410072,32.3741007194245,10.0719424460432,46.0431654676259,2.87769784172662,3.9568345323741,30.9352517985612,8.27338129496403
"E00021156",102,10,25,53,14,61,5,13,35,8,41,5,12,18,6,9.80392156862745,24.5098039215686,51.9607843137255,13.7254901960784,59.8039215686275,4.90196078431373,12.7450980392157,34.3137254901961,7.84313725490196,40.1960784313725,4.90196078431373,11.7647058823529,17.6470588235294,5.88235294117647
"E00021157",121,16,38,60,7,76,8,23,39,6,45,8,15,21,1,13.2231404958678,31.404958677686,49.5867768595041,5.78512396694215,62.8099173553719,6.61157024793388,19.0082644628099,32.2314049586777,4.95867768595041,37.1900826446281,6.61157024793388,12.396694214876,17.3553719008264,0.826446280991736
"E00021158",91,10,32,46,3,55,2,21,29,3,36,8,11,17,0,10.989010989011,35.1648351648352,50.5494505494505,3.2967032967033,60.4395604395604,2.1978021978022,23.0769230769231,31.8681318681319,3.2967032967033,39.5604395604396,8.79120879120879,12.0879120879121,18.6813186813187,0
"E00021159",249,17,41,169,22,136,9,18,93,16,113,8,23,76,6,6.82730923694779,16.4658634538153,67.8714859437751,8.83534136546185,54.6184738955823,3.6144578313253,7.2289156626506,37.3493975903614,6.42570281124498,45.3815261044177,3.21285140562249,9.23694779116466,30.5220883534137,2.40963855421687
"E00021160",121,13,30,71,7,68,9,15,38,6,53,4,15,33,1,10.7438016528926,24.7933884297521,58.6776859504132,5.78512396694215,56.198347107438,7.43801652892562,12.396694214876,31.404958677686,4.95867768595041,43.801652892562,3.30578512396694,12.396694214876,27.2727272727273,0.826446280991736
"E00021161",203,17,32,121,33,105,7,14,59,25,98,10,18,62,8,8.3743842364532,15.7635467980296,59.6059113300493,16.256157635468,51.7241379310345,3.44827586206897,6.89655172413793,29.064039408867,12.3152709359606,48.2758620689655,4.92610837438424,8.86699507389163,30.5418719211823,3.94088669950739
"E00021162",183,14,43,100,26,105,9,29,49,18,78,5,14,51,8,7.65027322404372,23.4972677595628,54.6448087431694,14.207650273224,57.3770491803279,4.91803278688525,15.8469945355191,26.775956284153,9.83606557377049,42.6229508196721,2.73224043715847,7.65027322404372,27.8688524590164,4.37158469945355
"E00021163",110,5,27,67,11,64,3,20,36,5,46,2,7,31,6,4.54545454545455,24.5454545454545,60.9090909090909,10,58.1818181818182,2.72727272727273,18.1818181818182,32.7272727272727,4.54545454545455,41.8181818181818,1.81818181818182,6.36363636363636,28.1818181818182,5.45454545454545
"E00021164",104,7,27,59,11,78,5,20,43,10,26,2,7,16,1,6.73076923076923,25.9615384615385,56.7307692307692,10.5769230769231,75,4.80769230769231,19.2307692307692,41.3461538461538,9.61538461538462,25,1.92307692307692,6.73076923076923,15.3846153846154,0.961538461538462
"E00021165",134,14,20,85,15,79,5,12,49,13,55,9,8,36,2,10.4477611940298,14.9253731343284,63.4328358208955,11.1940298507463,58.955223880597,3.73134328358209,8.95522388059701,36.5671641791045,9.70149253731343,41.044776119403,6.71641791044776,5.97014925373134,26.865671641791,1.49253731343284
"E00021166",176,15,31,106,24,106,5,20,63,18,70,10,11,43,6,8.52272727272727,17.6136363636364,60.2272727272727,13.6363636363636,60.2272727272727,2.84090909090909,11.3636363636364,35.7954545454545,10.2272727272727,39.7727272727273,5.68181818181818,6.25,24.4318181818182,3.40909090909091
"E00021167",154,12,22,99,21,90,2,18,58,12,64,10,4,41,9,7.79220779220779,14.2857142857143,64.2857142857143,13.6363636363636,58.4415584415584,1.2987012987013,11.6883116883117,37.6623376623377,7.79220779220779,41.5584415584416,6.49350649350649,2.5974025974026,26.6233766233766,5.84415584415584
"E00021168",319,15,27,202,75,173,12,8,98,55,146,3,19,104,20,4.70219435736677,8.46394984326019,63.3228840125392,23.5109717868339,54.2319749216301,3.76175548589342,2.50783699059561,30.7210031347962,17.2413793103448,45.7680250783699,0.940438871473354,5.95611285266458,32.6018808777429,6.26959247648903
"E00021169",262,9,33,172,48,141,6,19,92,24,121,3,14,80,24,3.43511450381679,12.5954198473282,65.6488549618321,18.3206106870229,53.8167938931298,2.29007633587786,7.25190839694656,35.1145038167939,9.16030534351145,46.1832061068702,1.14503816793893,5.34351145038168,30.5343511450382,9.16030534351145
"E00021170",180,21,51,90,18,98,10,30,50,8,82,11,21,40,10,11.6666666666667,28.3333333333333,50,10,54.4444444444444,5.55555555555556,16.6666666666667,27.7777777777778,4.44444444444444,45.5555555555556,6.11111111111111,11.6666666666667,22.2222222222222,5.55555555555556
"E00021171",252,27,58,133,34,128,14,34,61,19,124,13,24,72,15,10.7142857142857,23.015873015873,52.7777777777778,13.4920634920635,50.7936507936508,5.55555555555556,13.4920634920635,24.2063492063492,7.53968253968254,49.2063492063492,5.15873015873016,9.52380952380952,28.5714285714286,5.95238095238095
"E00021172",138,15,34,68,21,72,10,13,35,14,66,5,21,33,7,10.8695652173913,24.6376811594203,49.2753623188406,15.2173913043478,52.1739130434783,7.2463768115942,9.42028985507246,25.3623188405797,10.1449275362319,47.8260869565217,3.6231884057971,15.2173913043478,23.9130434782609,5.07246376811594
"E00021173",177,11,31,112,23,101,4,16,64,17,76,7,15,48,6,6.21468926553672,17.5141242937853,63.2768361581921,12.9943502824859,57.0621468926554,2.25988700564972,9.03954802259887,36.1581920903955,9.6045197740113,42.9378531073446,3.95480225988701,8.47457627118644,27.1186440677966,3.38983050847458
"E00021174",199,4,26,129,40,106,2,11,70,23,93,2,15,59,17,2.01005025125628,13.0653266331658,64.8241206030151,20.1005025125628,53.2663316582915,1.00502512562814,5.52763819095477,35.1758793969849,11.5577889447236,46.7336683417085,1.00502512562814,7.53768844221105,29.6482412060301,8.5427135678392
"E00021175",179,18,31,107,23,95,8,19,53,15,84,10,12,54,8,10.0558659217877,17.3184357541899,59.7765363128492,12.8491620111732,53.072625698324,4.46927374301676,10.6145251396648,29.608938547486,8.37988826815642,46.927374301676,5.58659217877095,6.70391061452514,30.1675977653631,4.46927374301676
"E00021176",163,15,37,92,19,78,3,17,43,15,85,12,20,49,4,9.20245398773006,22.6993865030675,56.441717791411,11.6564417177914,47.8527607361963,1.84049079754601,10.4294478527607,26.3803680981595,9.20245398773006,52.1472392638037,7.36196319018405,12.2699386503067,30.0613496932515,2.45398773006135
"E00021177",140,15,36,72,17,93,9,29,44,11,47,6,7,28,6,10.7142857142857,25.7142857142857,51.4285714285714,12.1428571428571,66.4285714285714,6.42857142857143,20.7142857142857,31.4285714285714,7.85714285714286,33.5714285714286,4.28571428571429,5,20,4.28571428571429
"E00021179",186,15,22,111,38,107,5,11,65,26,79,10,11,46,12,8.06451612903226,11.8279569892473,59.6774193548387,20.4301075268817,57.5268817204301,2.68817204301075,5.91397849462366,34.9462365591398,13.9784946236559,42.4731182795699,5.37634408602151,5.91397849462366,24.7311827956989,6.45161290322581
"E00021180",179,21,43,95,20,107,11,26,55,15,72,10,17,40,5,11.731843575419,24.0223463687151,53.072625698324,11.1731843575419,59.7765363128492,6.14525139664804,14.5251396648045,30.7262569832402,8.37988826815642,40.2234636871508,5.58659217877095,9.49720670391061,22.3463687150838,2.79329608938547
"E00021181",133,14,22,74,23,75,12,11,40,12,58,2,11,34,11,10.5263157894737,16.5413533834586,55.6390977443609,17.2932330827068,56.390977443609,9.02255639097744,8.27067669172932,30.0751879699248,9.02255639097744,43.609022556391,1.50375939849624,8.27067669172932,25.5639097744361,8.27067669172932
"E00021182",239,13,28,150,48,137,10,16,79,32,102,3,12,71,16,5.43933054393306,11.7154811715481,62.7615062761506,20.0836820083682,57.3221757322176,4.18410041841004,6.69456066945607,33.0543933054393,13.3891213389121,42.6778242677824,1.25523012552301,5.02092050209205,29.7071129707113,6.69456066945607
"E00021183",179,8,22,111,38,96,4,9,60,23,83,4,13,51,15,4.46927374301676,12.2905027932961,62.0111731843575,21.2290502793296,53.6312849162011,2.23463687150838,5.02793296089385,33.5195530726257,12.8491620111732,46.3687150837989,2.23463687150838,7.26256983240224,28.4916201117318,8.37988826815642
"E00021184",96,3,11,64,18,45,1,6,32,6,51,2,5,32,12,3.125,11.4583333333333,66.6666666666667,18.75,46.875,1.04166666666667,6.25,33.3333333333333,6.25,53.125,2.08333333333333,5.20833333333333,33.3333333333333,12.5
"E00021185",166,11,40,87,28,83,7,20,40,16,83,4,20,47,12,6.62650602409639,24.0963855421687,52.4096385542169,16.8674698795181,50,4.21686746987952,12.0481927710843,24.0963855421687,9.63855421686747,50,2.40963855421687,12.0481927710843,28.3132530120482,7.2289156626506
"E00021186",145,8,49,75,13,83,4,37,35,7,62,4,12,40,6,5.51724137931035,33.7931034482759,51.7241379310345,8.96551724137931,57.2413793103448,2.75862068965517,25.5172413793103,24.1379310344828,4.82758620689655,42.7586206896552,2.75862068965517,8.27586206896552,27.5862068965517,4.13793103448276
"E00021187",87,10,26,42,9,53,4,16,25,8,34,6,10,17,1,11.4942528735632,29.8850574712644,48.2758620689655,10.3448275862069,60.9195402298851,4.59770114942529,18.3908045977011,28.735632183908,9.19540229885057,39.0804597701149,6.89655172413793,11.4942528735632,19.5402298850575,1.14942528735632
"E00021188",114,19,24,59,12,64,4,17,33,10,50,15,7,26,2,16.6666666666667,21.0526315789474,51.7543859649123,10.5263157894737,56.140350877193,3.50877192982456,14.9122807017544,28.9473684210526,8.7719298245614,43.859649122807,13.1578947368421,6.14035087719298,22.8070175438596,1.75438596491228
"E00021189",144,21,25,86,12,71,7,15,43,6,73,14,10,43,6,14.5833333333333,17.3611111111111,59.7222222222222,8.33333333333333,49.3055555555556,4.86111111111111,10.4166666666667,29.8611111111111,4.16666666666667,50.6944444444444,9.72222222222222,6.94444444444444,29.8611111111111,4.16666666666667
"E00021190",257,14,48,157,38,141,7,24,83,27,116,7,24,74,11,5.44747081712062,18.6770428015564,61.0894941634241,14.7859922178988,54.863813229572,2.72373540856031,9.33852140077821,32.295719844358,10.5058365758755,45.136186770428,2.72373540856031,9.33852140077821,28.7937743190661,4.28015564202335
"E00021191",163,11,45,91,16,103,7,32,55,9,60,4,13,36,7,6.74846625766871,27.6073619631902,55.8282208588957,9.8159509202454,63.1901840490798,4.29447852760736,19.6319018404908,33.7423312883436,5.52147239263804,36.8098159509202,2.45398773006135,7.97546012269939,22.0858895705521,4.29447852760736
"E00021192",116,16,33,61,6,77,12,21,41,3,39,4,12,20,3,13.7931034482759,28.448275862069,52.5862068965517,5.17241379310345,66.3793103448276,10.3448275862069,18.1034482758621,35.3448275862069,2.58620689655172,33.6206896551724,3.44827586206897,10.3448275862069,17.2413793103448,2.58620689655172
"E00021193",246,11,15,152,68,159,3,9,95,52,87,8,6,57,16,4.47154471544715,6.09756097560976,61.7886178861789,27.6422764227642,64.6341463414634,1.21951219512195,3.65853658536585,38.6178861788618,21.1382113821138,35.3658536585366,3.2520325203252,2.4390243902439,23.1707317073171,6.50406504065041
"E00021194",197,26,58,95,18,127,16,41,56,14,70,10,17,39,4,13.1979695431472,29.4416243654822,48.2233502538071,9.13705583756345,64.4670050761421,8.12182741116751,20.8121827411168,28.4263959390863,7.10659898477157,35.5329949238579,5.0761421319797,8.62944162436548,19.7969543147208,2.03045685279188
"E00021195",150,10,34,91,15,97,4,20,64,9,53,6,14,27,6,6.66666666666667,22.6666666666667,60.6666666666667,10,64.6666666666667,2.66666666666667,13.3333333333333,42.6666666666667,6,35.3333333333333,4,9.33333333333333,18,4
"E00021196",111,14,35,49,13,68,8,29,26,5,43,6,6,23,8,12.6126126126126,31.5315315315315,44.1441441441441,11.7117117117117,61.2612612612613,7.20720720720721,26.1261261261261,23.4234234234234,4.5045045045045,38.7387387387387,5.40540540540541,5.40540540540541,20.7207207207207,7.20720720720721
"E00021197",245,14,33,139,59,142,8,18,75,41,103,6,15,64,18,5.71428571428571,13.469387755102,56.734693877551,24.0816326530612,57.9591836734694,3.26530612244898,7.34693877551021,30.6122448979592,16.734693877551,42.0408163265306,2.44897959183673,6.12244897959184,26.1224489795918,7.34693877551021
"E00021198",110,6,28,59,17,59,5,15,29,10,51,1,13,30,7,5.45454545454545,25.4545454545455,53.6363636363636,15.4545454545455,53.6363636363636,4.54545454545455,13.6363636363636,26.3636363636364,9.09090909090909,46.3636363636364,0.909090909090909,11.8181818181818,27.2727272727273,6.36363636363636
"E00021199",78,10,13,46,9,43,5,8,24,6,35,5,5,22,3,12.8205128205128,16.6666666666667,58.974358974359,11.5384615384615,55.1282051282051,6.41025641025641,10.2564102564103,30.7692307692308,7.69230769230769,44.8717948717949,6.41025641025641,6.41025641025641,28.2051282051282,3.84615384615385
"E00021200",126,12,37,68,9,77,5,29,37,6,49,7,8,31,3,9.52380952380952,29.3650793650794,53.968253968254,7.14285714285714,61.1111111111111,3.96825396825397,23.015873015873,29.3650793650794,4.76190476190476,38.8888888888889,5.55555555555556,6.34920634920635,24.6031746031746,2.38095238095238
"E00021201",136,10,27,82,17,78,4,14,47,13,58,6,13,35,4,7.35294117647059,19.8529411764706,60.2941176470588,12.5,57.3529411764706,2.94117647058824,10.2941176470588,34.5588235294118,9.55882352941176,42.6470588235294,4.41176470588235,9.55882352941176,25.7352941176471,2.94117647058824
"E00021202",85,9,24,41,11,45,3,19,19,4,40,6,5,22,7,10.5882352941176,28.2352941176471,48.2352941176471,12.9411764705882,52.9411764705882,3.52941176470588,22.3529411764706,22.3529411764706,4.70588235294118,47.0588235294118,7.05882352941176,5.88235294117647,25.8823529411765,8.23529411764706
"E00021203",100,11,25,59,5,58,8,16,30,4,42,3,9,29,1,11,25,59,5,58,8,16,30,4,42,3,9,29,1
"E00021204",163,23,35,86,19,103,18,21,52,12,60,5,14,34,7,14.1104294478528,21.4723926380368,52.760736196319,11.6564417177914,63.1901840490798,11.0429447852761,12.8834355828221,31.9018404907975,7.36196319018405,36.8098159509202,3.06748466257669,8.58895705521472,20.8588957055215,4.29447852760736
"E00021205",110,16,31,57,6,71,9,21,36,5,39,7,10,21,1,14.5454545454545,28.1818181818182,51.8181818181818,5.45454545454545,64.5454545454545,8.18181818181818,19.0909090909091,32.7272727272727,4.54545454545455,35.4545454545455,6.36363636363636,9.09090909090909,19.0909090909091,0.909090909090909
"E00021206",67,6,28,28,5,43,3,18,18,4,24,3,10,10,1,8.95522388059701,41.7910447761194,41.7910447761194,7.46268656716418,64.1791044776119,4.47761194029851,26.865671641791,26.865671641791,5.97014925373134,35.8208955223881,4.47761194029851,14.9253731343284,14.9253731343284,1.49253731343284
"E00021207",189,5,17,125,42,99,3,6,70,20,90,2,11,55,22,2.64550264550265,8.99470899470899,66.1375661375661,22.2222222222222,52.3809523809524,1.58730158730159,3.17460317460317,37.037037037037,10.5820105820106,47.6190476190476,1.05820105820106,5.82010582010582,29.1005291005291,11.6402116402116
"E00021208",100,8,32,55,5,65,3,25,34,3,35,5,7,21,2,8,32,55,5,65,3,25,34,3,35,5,7,21,2
"E00021209",96,12,24,53,7,53,4,13,31,5,43,8,11,22,2,12.5,25,55.2083333333333,7.29166666666667,55.2083333333333,4.16666666666667,13.5416666666667,32.2916666666667,5.20833333333333,44.7916666666667,8.33333333333333,11.4583333333333,22.9166666666667,2.08333333333333
"E00021210",121,21,31,65,4,77,11,19,43,4,44,10,12,22,0,17.3553719008264,25.6198347107438,53.7190082644628,3.30578512396694,63.6363636363636,9.09090909090909,15.702479338843,35.5371900826446,3.30578512396694,36.3636363636364,8.26446280991736,9.91735537190083,18.1818181818182,0
"E00021211",194,24,36,110,24,116,13,16,72,15,78,11,20,38,9,12.3711340206186,18.5567010309278,56.701030927835,12.3711340206186,59.7938144329897,6.70103092783505,8.24742268041237,37.1134020618557,7.7319587628866,40.2061855670103,5.67010309278351,10.3092783505155,19.5876288659794,4.63917525773196
"E00021212",92,15,34,37,6,61,9,22,25,5,31,6,12,12,1,16.304347826087,36.9565217391304,40.2173913043478,6.52173913043478,66.304347826087,9.78260869565217,23.9130434782609,27.1739130434783,5.43478260869565,33.695652173913,6.52173913043478,13.0434782608696,13.0434782608696,1.08695652173913
"E00021213",140,20,52,55,13,87,11,35,33,8,53,9,17,22,5,14.2857142857143,37.1428571428571,39.2857142857143,9.28571428571429,62.1428571428571,7.85714285714286,25,23.5714285714286,5.71428571428571,37.8571428571429,6.42857142857143,12.1428571428571,15.7142857142857,3.57142857142857
"E00021214",182,23,39,98,22,103,9,25,55,14,79,14,14,43,8,12.6373626373626,21.4285714285714,53.8461538461538,12.0879120879121,56.5934065934066,4.94505494505495,13.7362637362637,30.2197802197802,7.69230769230769,43.4065934065934,7.69230769230769,7.69230769230769,23.6263736263736,4.3956043956044
"E00021215",233,22,38,125,48,120,5,18,66,31,113,17,20,59,17,9.44206008583691,16.3090128755365,53.6480686695279,20.6008583690987,51.5021459227468,2.14592274678112,7.72532188841202,28.3261802575107,13.3047210300429,48.4978540772532,7.29613733905579,8.58369098712446,25.3218884120172,7.29613733905579
"E00021216",128,18,39,59,12,67,3,22,34,8,61,15,17,25,4,14.0625,30.46875,46.09375,9.375,52.34375,2.34375,17.1875,26.5625,6.25,47.65625,11.71875,13.28125,19.53125,3.125
"E00021217",150,20,39,71,20,87,11,24,39,13,63,9,15,32,7,13.3333333333333,26,47.3333333333333,13.3333333333333,58,7.33333333333333,16,26,8.66666666666667,42,6,10,21.3333333333333,4.66666666666667
"E00021218",287,16,30,186,55,170,9,12,107,42,117,7,18,79,13,5.57491289198606,10.4529616724739,64.808362369338,19.1637630662021,59.2334494773519,3.13588850174216,4.18118466898955,37.2822299651568,14.6341463414634,40.7665505226481,2.4390243902439,6.27177700348432,27.5261324041812,4.52961672473868
"E00021219",134,15,22,80,17,72,6,6,48,12,62,9,16,32,5,11.1940298507463,16.4179104477612,59.7014925373134,12.6865671641791,53.7313432835821,4.47761194029851,4.47761194029851,35.8208955223881,8.95522388059701,46.2686567164179,6.71641791044776,11.9402985074627,23.8805970149254,3.73134328358209
"E00021220",226,6,18,156,46,122,2,5,88,27,104,4,13,68,19,2.65486725663717,7.9646017699115,69.0265486725664,20.353982300885,53.9823008849557,0.884955752212389,2.21238938053097,38.9380530973451,11.9469026548673,46.0176991150442,1.76991150442478,5.75221238938053,30.0884955752212,8.4070796460177
"E00021223",291,16,16,186,73,175,6,7,104,58,116,10,9,82,15,5.49828178694158,5.49828178694158,63.9175257731959,25.085910652921,60.1374570446735,2.06185567010309,2.40549828178694,35.7388316151203,19.9312714776632,39.8625429553265,3.43642611683849,3.09278350515464,28.1786941580756,5.15463917525773
"E00021224",217,17,32,132,36,137,9,21,79,28,80,8,11,53,8,7.83410138248848,14.7465437788018,60.8294930875576,16.5898617511521,63.1336405529954,4.14746543778802,9.67741935483871,36.405529953917,12.9032258064516,36.8663594470046,3.68663594470046,5.06912442396313,24.4239631336406,3.68663594470046
"E00021225",138,2,25,92,19,81,2,10,53,16,57,0,15,39,3,1.44927536231884,18.1159420289855,66.6666666666667,13.768115942029,58.695652173913,1.44927536231884,7.2463768115942,38.4057971014493,11.5942028985507,41.304347826087,0,10.8695652173913,28.2608695652174,2.17391304347826
"E00021227",156,8,25,101,22,81,4,7,51,19,75,4,18,50,3,5.12820512820513,16.025641025641,64.7435897435898,14.1025641025641,51.9230769230769,2.56410256410256,4.48717948717949,32.6923076923077,12.1794871794872,48.0769230769231,2.56410256410256,11.5384615384615,32.0512820512821,1.92307692307692
"E00021228",158,10,35,93,20,88,4,15,52,17,70,6,20,41,3,6.32911392405063,22.1518987341772,58.8607594936709,12.6582278481013,55.6962025316456,2.53164556962025,9.49367088607595,32.9113924050633,10.7594936708861,44.3037974683544,3.79746835443038,12.6582278481013,25.9493670886076,1.89873417721519
"E00021229",112,8,33,58,13,66,2,21,31,12,46,6,12,27,1,7.14285714285714,29.4642857142857,51.7857142857143,11.6071428571429,58.9285714285714,1.78571428571429,18.75,27.6785714285714,10.7142857142857,41.0714285714286,5.35714285714286,10.7142857142857,24.1071428571429,0.892857142857143
"E00021230",140,4,15,90,31,75,2,4,47,22,65,2,11,43,9,2.85714285714286,10.7142857142857,64.2857142857143,22.1428571428571,53.5714285714286,1.42857142857143,2.85714285714286,33.5714285714286,15.7142857142857,46.4285714285714,1.42857142857143,7.85714285714286,30.7142857142857,6.42857142857143
"E00021231",107,3,17,61,26,61,1,6,34,20,46,2,11,27,6,2.80373831775701,15.8878504672897,57.0093457943925,24.2990654205607,57.0093457943925,0.934579439252336,5.60747663551402,31.7757009345794,18.6915887850467,42.9906542056075,1.86915887850467,10.2803738317757,25.2336448598131,5.60747663551402
"E00021235",86,17,31,35,3,47,7,17,20,3,39,10,14,15,0,19.7674418604651,36.046511627907,40.6976744186046,3.48837209302326,54.6511627906977,8.13953488372093,19.7674418604651,23.2558139534884,3.48837209302326,45.3488372093023,11.6279069767442,16.2790697674419,17.4418604651163,0
"E00021236",155,14,29,92,20,95,5,21,53,16,60,9,8,39,4,9.03225806451613,18.7096774193548,59.3548387096774,12.9032258064516,61.2903225806452,3.2258064516129,13.5483870967742,34.1935483870968,10.3225806451613,38.7096774193548,5.80645161290323,5.16129032258065,25.1612903225806,2.58064516129032
"E00021238",288,8,12,173,95,179,5,1,107,66,109,3,11,66,29,2.77777777777778,4.16666666666667,60.0694444444444,32.9861111111111,62.1527777777778,1.73611111111111,0.347222222222222,37.1527777777778,22.9166666666667,37.8472222222222,1.04166666666667,3.81944444444444,22.9166666666667,10.0694444444444
"E00021239",209,9,6,135,59,117,4,1,67,45,92,5,5,68,14,4.30622009569378,2.87081339712919,64.5933014354067,28.2296650717703,55.9808612440191,1.91387559808612,0.478468899521531,32.0574162679426,21.5311004784689,44.0191387559809,2.39234449760766,2.39234449760766,32.5358851674641,6.69856459330144
"E00021240",245,8,14,157,66,142,1,5,90,46,103,7,9,67,20,3.26530612244898,5.71428571428571,64.0816326530612,26.9387755102041,57.9591836734694,0.408163265306122,2.04081632653061,36.734693877551,18.7755102040816,42.0408163265306,2.85714285714286,3.6734693877551,27.3469387755102,8.16326530612245
"E00021241",206,10,33,127,36,125,2,14,83,26,81,8,19,44,10,4.85436893203883,16.0194174757282,61.6504854368932,17.4757281553398,60.6796116504854,0.970873786407767,6.79611650485437,40.2912621359223,12.621359223301,39.3203883495146,3.88349514563107,9.22330097087379,21.3592233009709,4.85436893203883
"E00021243",148,9,27,95,17,94,5,11,63,15,54,4,16,32,2,6.08108108108108,18.2432432432432,64.1891891891892,11.4864864864865,63.5135135135135,3.37837837837838,7.43243243243243,42.5675675675676,10.1351351351351,36.4864864864865,2.7027027027027,10.8108108108108,21.6216216216216,1.35135135135135
"E00021244",75,10,18,39,8,42,3,10,25,4,33,7,8,14,4,13.3333333333333,24,52,10.6666666666667,56,4,13.3333333333333,33.3333333333333,5.33333333333333,44,9.33333333333333,10.6666666666667,18.6666666666667,5.33333333333333
"E00021245",94,5,15,64,10,50,0,8,36,6,44,5,7,28,4,5.31914893617021,15.9574468085106,68.0851063829787,10.6382978723404,53.1914893617021,0,8.51063829787234,38.2978723404255,6.38297872340426,46.8085106382979,5.31914893617021,7.4468085106383,29.7872340425532,4.25531914893617
"E00021246",218,14,39,137,28,132,7,22,84,19,86,7,17,53,9,6.42201834862385,17.8899082568807,62.8440366972477,12.8440366972477,60.5504587155963,3.21100917431193,10.0917431192661,38.5321100917431,8.71559633027523,39.4495412844037,3.21100917431193,7.79816513761468,24.3119266055046,4.12844036697248
"E00021247",128,22,38,58,10,73,8,24,35,6,55,14,14,23,4,17.1875,29.6875,45.3125,7.8125,57.03125,6.25,18.75,27.34375,4.6875,42.96875,10.9375,10.9375,17.96875,3.125
"E00021248",134,13,45,57,19,80,2,28,37,13,54,11,17,20,6,9.70149253731343,33.5820895522388,42.5373134328358,14.1791044776119,59.7014925373134,1.49253731343284,20.8955223880597,27.6119402985075,9.70149253731343,40.2985074626866,8.2089552238806,12.6865671641791,14.9253731343284,4.47761194029851
"E00021249",122,9,34,66,13,61,6,15,30,10,61,3,19,36,3,7.37704918032787,27.8688524590164,54.0983606557377,10.655737704918,50,4.91803278688525,12.2950819672131,24.5901639344262,8.19672131147541,50,2.45901639344262,15.5737704918033,29.5081967213115,2.45901639344262
"E00021251",121,10,20,75,16,69,5,9,44,11,52,5,11,31,5,8.26446280991736,16.5289256198347,61.9834710743802,13.2231404958678,57.0247933884297,4.13223140495868,7.43801652892562,36.3636363636364,9.09090909090909,42.9752066115703,4.13223140495868,9.09090909090909,25.6198347107438,4.13223140495868
"E00021252",207,15,16,128,48,123,11,5,72,35,84,4,11,56,13,7.2463768115942,7.72946859903382,61.8357487922705,23.1884057971014,59.4202898550725,5.31400966183575,2.41545893719807,34.7826086956522,16.9082125603865,40.5797101449275,1.93236714975845,5.31400966183575,27.0531400966184,6.28019323671498
"E00021253",123,11,18,77,17,78,5,11,48,14,45,6,7,29,3,8.94308943089431,14.6341463414634,62.6016260162602,13.8211382113821,63.4146341463415,4.0650406504065,8.94308943089431,39.0243902439024,11.3821138211382,36.5853658536585,4.8780487804878,5.69105691056911,23.5772357723577,2.4390243902439
"E00021254",163,6,10,107,40,100,3,3,69,25,63,3,7,38,15,3.68098159509202,6.13496932515337,65.6441717791411,24.5398773006135,61.3496932515337,1.84049079754601,1.84049079754601,42.3312883435583,15.3374233128834,38.6503067484663,1.84049079754601,4.29447852760736,23.3128834355828,9.20245398773006
"E00021255",163,8,8,104,43,98,4,2,64,28,65,4,6,40,15,4.9079754601227,4.9079754601227,63.8036809815951,26.3803680981595,60.1226993865031,2.45398773006135,1.22699386503067,39.2638036809816,17.1779141104294,39.8773006134969,2.45398773006135,3.68098159509202,24.5398773006135,9.20245398773006
"E00021256",155,7,13,102,33,93,2,7,55,29,62,5,6,47,4,4.51612903225806,8.38709677419355,65.8064516129032,21.2903225806452,60,1.29032258064516,4.51612903225806,35.4838709677419,18.7096774193548,40,3.2258064516129,3.87096774193548,30.3225806451613,2.58064516129032
"E00021257",153,7,18,95,33,79,2,6,50,21,74,5,12,45,12,4.57516339869281,11.7647058823529,62.0915032679739,21.5686274509804,51.6339869281046,1.30718954248366,3.92156862745098,32.6797385620915,13.7254901960784,48.3660130718954,3.26797385620915,7.84313725490196,29.4117647058824,7.84313725490196
"E00021258",126,15,28,67,16,71,6,15,36,14,55,9,13,31,2,11.9047619047619,22.2222222222222,53.1746031746032,12.6984126984127,56.3492063492063,4.76190476190476,11.9047619047619,28.5714285714286,11.1111111111111,43.6507936507937,7.14285714285714,10.3174603174603,24.6031746031746,1.58730158730159
"E00021259",163,11,33,102,17,87,3,12,61,11,76,8,21,41,6,6.74846625766871,20.2453987730061,62.5766871165644,10.4294478527607,53.3742331288344,1.84049079754601,7.36196319018405,37.4233128834356,6.74846625766871,46.6257668711656,4.9079754601227,12.8834355828221,25.1533742331288,3.68098159509202
"E00021260",120,14,19,67,20,66,5,9,38,14,54,9,10,29,6,11.6666666666667,15.8333333333333,55.8333333333333,16.6666666666667,55,4.16666666666667,7.5,31.6666666666667,11.6666666666667,45,7.5,8.33333333333333,24.1666666666667,5
"E00021261",124,9,14,81,20,60,2,5,39,14,64,7,9,42,6,7.25806451612903,11.2903225806452,65.3225806451613,16.1290322580645,48.3870967741936,1.61290322580645,4.03225806451613,31.4516129032258,11.2903225806452,51.6129032258064,5.64516129032258,7.25806451612903,33.8709677419355,4.83870967741935
"E00021262",111,14,41,51,5,55,7,16,29,3,56,7,25,22,2,12.6126126126126,36.9369369369369,45.945945945946,4.5045045045045,49.5495495495495,6.30630630630631,14.4144144144144,26.1261261261261,2.7027027027027,50.4504504504504,6.30630630630631,22.5225225225225,19.8198198198198,1.8018018018018
"E00021263",228,11,38,147,32,109,4,14,72,19,119,7,24,75,13,4.82456140350877,16.6666666666667,64.4736842105263,14.0350877192982,47.8070175438597,1.75438596491228,6.14035087719298,31.5789473684211,8.33333333333333,52.1929824561403,3.07017543859649,10.5263157894737,32.8947368421053,5.70175438596491
"E00021266",176,18,24,100,34,86,10,5,47,24,90,8,19,53,10,10.2272727272727,13.6363636363636,56.8181818181818,19.3181818181818,48.8636363636364,5.68181818181818,2.84090909090909,26.7045454545455,13.6363636363636,51.1363636363636,4.54545454545455,10.7954545454545,30.1136363636364,5.68181818181818
"E00021267",139,9,34,79,17,64,2,12,42,8,75,7,22,37,9,6.47482014388489,24.4604316546763,56.8345323741007,12.2302158273381,46.0431654676259,1.43884892086331,8.63309352517986,30.2158273381295,5.75539568345324,53.9568345323741,5.03597122302158,15.8273381294964,26.6187050359712,6.47482014388489
"E00021268",126,14,26,71,15,69,4,13,39,13,57,10,13,32,2,11.1111111111111,20.6349206349206,56.3492063492063,11.9047619047619,54.7619047619048,3.17460317460317,10.3174603174603,30.952380952381,10.3174603174603,45.2380952380952,7.93650793650794,10.3174603174603,25.3968253968254,1.58730158730159
"E00021271",176,12,22,116,26,87,4,10,57,16,89,8,12,59,10,6.81818181818182,12.5,65.9090909090909,14.7727272727273,49.4318181818182,2.27272727272727,5.68181818181818,32.3863636363636,9.09090909090909,50.5681818181818,4.54545454545455,6.81818181818182,33.5227272727273,5.68181818181818
"E00021272",93,9,20,54,10,51,4,12,28,7,42,5,8,26,3,9.67741935483871,21.505376344086,58.0645161290323,10.752688172043,54.8387096774194,4.3010752688172,12.9032258064516,30.1075268817204,7.52688172043011,45.1612903225806,5.37634408602151,8.60215053763441,27.9569892473118,3.2258064516129
"E00021273",112,11,28,63,10,50,3,11,29,7,62,8,17,34,3,9.82142857142857,25,56.25,8.92857142857143,44.6428571428571,2.67857142857143,9.82142857142857,25.8928571428571,6.25,55.3571428571429,7.14285714285714,15.1785714285714,30.3571428571429,2.67857142857143
"E00021274",158,17,43,83,15,92,5,22,54,11,66,12,21,29,4,10.7594936708861,27.2151898734177,52.5316455696203,9.49367088607595,58.2278481012658,3.16455696202532,13.9240506329114,34.1772151898734,6.9620253164557,41.7721518987342,7.59493670886076,13.2911392405063,18.3544303797468,2.53164556962025
"E00021275",96,8,17,58,13,53,3,6,36,8,43,5,11,22,5,8.33333333333333,17.7083333333333,60.4166666666667,13.5416666666667,55.2083333333333,3.125,6.25,37.5,8.33333333333333,44.7916666666667,5.20833333333333,11.4583333333333,22.9166666666667,5.20833333333333
"E00021277",93,10,17,55,11,40,4,5,23,8,53,6,12,32,3,10.752688172043,18.2795698924731,59.1397849462366,11.8279569892473,43.010752688172,4.3010752688172,5.37634408602151,24.7311827956989,8.60215053763441,56.989247311828,6.45161290322581,12.9032258064516,34.4086021505376,3.2258064516129
"E00021278",67,4,10,43,10,40,1,3,29,7,27,3,7,14,3,5.97014925373134,14.9253731343284,64.1791044776119,14.9253731343284,59.7014925373134,1.49253731343284,4.47761194029851,43.2835820895522,10.4477611940298,40.2985074626866,4.47761194029851,10.4477611940298,20.8955223880597,4.47761194029851
"E00021279",141,13,33,81,14,78,3,14,50,11,63,10,19,31,3,9.21985815602837,23.4042553191489,57.4468085106383,9.9290780141844,55.3191489361702,2.12765957446809,9.9290780141844,35.4609929078014,7.80141843971631,44.6808510638298,7.09219858156028,13.4751773049645,21.9858156028369,2.12765957446809
"E00021280",143,11,30,87,15,72,5,15,44,8,71,6,15,43,7,7.69230769230769,20.979020979021,60.8391608391608,10.4895104895105,50.3496503496504,3.4965034965035,10.4895104895105,30.7692307692308,5.59440559440559,49.6503496503497,4.1958041958042,10.4895104895105,30.0699300699301,4.89510489510489
"E00021281",289,24,64,163,38,147,7,22,91,27,142,17,42,72,11,8.30449826989619,22.1453287197232,56.401384083045,13.1487889273356,50.8650519031142,2.42214532871972,7.61245674740484,31.4878892733564,9.34256055363322,49.1349480968858,5.88235294117647,14.5328719723183,24.9134948096886,3.80622837370242
"E00021282",202,10,23,128,41,93,3,13,57,20,109,7,10,71,21,4.95049504950495,11.3861386138614,63.3663366336634,20.2970297029703,46.039603960396,1.48514851485149,6.43564356435644,28.2178217821782,9.9009900990099,53.960396039604,3.46534653465347,4.95049504950495,35.1485148514851,10.3960396039604
"E00021285",94,2,7,67,18,51,0,4,40,7,43,2,3,27,11,2.12765957446809,7.4468085106383,71.2765957446808,19.1489361702128,54.2553191489362,0,4.25531914893617,42.5531914893617,7.4468085106383,45.7446808510638,2.12765957446809,3.19148936170213,28.7234042553192,11.7021276595745
"E00021286",157,12,17,91,37,84,8,9,47,20,73,4,8,44,17,7.64331210191083,10.828025477707,57.9617834394904,23.5668789808917,53.5031847133758,5.09554140127389,5.73248407643312,29.9363057324841,12.7388535031847,46.4968152866242,2.54777070063694,5.09554140127389,28.0254777070064,10.828025477707
"E00021287",251,8,18,159,66,148,4,7,90,47,103,4,11,69,19,3.18725099601594,7.17131474103586,63.3466135458167,26.2948207171315,58.9641434262948,1.59362549800797,2.78884462151394,35.8565737051793,18.7250996015936,41.0358565737052,1.59362549800797,4.38247011952191,27.4900398406374,7.56972111553785
"E00021288",203,8,4,139,52,120,4,2,82,32,83,4,2,57,20,3.94088669950739,1.97044334975369,68.4729064039409,25.615763546798,59.1133004926108,1.97044334975369,0.985221674876847,40.3940886699507,15.7635467980296,40.8866995073892,1.97044334975369,0.985221674876847,28.0788177339901,9.85221674876847
"E00021289",103,17,28,50,8,63,7,17,31,8,40,10,11,19,0,16.504854368932,27.1844660194175,48.5436893203884,7.76699029126214,61.1650485436893,6.79611650485437,16.504854368932,30.0970873786408,7.76699029126214,38.8349514563107,9.70873786407767,10.6796116504854,18.4466019417476,0
"E00021290",115,8,35,61,11,53,3,14,29,7,62,5,21,32,4,6.95652173913043,30.4347826086957,53.0434782608696,9.56521739130435,46.0869565217391,2.60869565217391,12.1739130434783,25.2173913043478,6.08695652173913,53.9130434782609,4.34782608695652,18.2608695652174,27.8260869565217,3.47826086956522
"E00021291",326,9,21,205,91,183,5,9,101,68,143,4,12,104,23,2.76073619631902,6.44171779141104,62.8834355828221,27.9141104294479,56.1349693251534,1.53374233128834,2.76073619631902,30.9815950920245,20.8588957055215,43.8650306748466,1.22699386503067,3.68098159509202,31.9018404907975,7.05521472392638
"E00021292",105,10,26,59,10,51,5,9,31,6,54,5,17,28,4,9.52380952380952,24.7619047619048,56.1904761904762,9.52380952380952,48.5714285714286,4.76190476190476,8.57142857142857,29.5238095238095,5.71428571428571,51.4285714285714,4.76190476190476,16.1904761904762,26.6666666666667,3.80952380952381
"E00021294",163,24,43,81,15,86,6,24,48,8,77,18,19,33,7,14.7239263803681,26.3803680981595,49.6932515337423,9.20245398773006,52.760736196319,3.68098159509202,14.7239263803681,29.4478527607362,4.9079754601227,47.239263803681,11.0429447852761,11.6564417177914,20.2453987730061,4.29447852760736
"E00021295",212,14,32,129,37,111,4,12,72,23,101,10,20,57,14,6.60377358490566,15.0943396226415,60.8490566037736,17.4528301886792,52.3584905660377,1.88679245283019,5.66037735849057,33.9622641509434,10.8490566037736,47.6415094339623,4.71698113207547,9.43396226415094,26.8867924528302,6.60377358490566
"E00021296",226,11,22,141,52,120,4,6,76,34,106,7,16,65,18,4.86725663716814,9.73451327433628,62.3893805309734,23.0088495575221,53.0973451327434,1.76991150442478,2.65486725663717,33.6283185840708,15.0442477876106,46.9026548672566,3.09734513274336,7.07964601769912,28.7610619469027,7.9646017699115
"E00021297",220,11,22,149,38,107,6,10,69,22,113,5,12,80,16,5,10,67.7272727272727,17.2727272727273,48.6363636363636,2.72727272727273,4.54545454545455,31.3636363636364,10,51.3636363636364,2.27272727272727,5.45454545454545,36.3636363636364,7.27272727272727
"E00021298",274,8,30,174,62,147,1,16,94,36,127,7,14,80,26,2.91970802919708,10.9489051094891,63.5036496350365,22.6277372262774,53.6496350364963,0.364963503649635,5.83941605839416,34.3065693430657,13.1386861313869,46.3503649635037,2.55474452554745,5.10948905109489,29.1970802919708,9.48905109489051
"E00021299",239,18,42,139,40,124,8,23,73,20,115,10,19,66,20,7.53138075313808,17.5732217573222,58.1589958158996,16.7364016736402,51.8828451882845,3.34728033472803,9.6234309623431,30.5439330543933,8.36820083682008,48.1171548117155,4.18410041841004,7.94979079497908,27.6150627615063,8.36820083682008
"E00021300",306,19,32,176,79,159,7,14,90,48,147,12,18,86,31,6.20915032679739,10.4575163398693,57.516339869281,25.8169934640523,51.9607843137255,2.28758169934641,4.57516339869281,29.4117647058824,15.6862745098039,48.0392156862745,3.92156862745098,5.88235294117647,28.1045751633987,10.1307189542484
"E00021301",144,11,47,72,14,68,3,22,35,8,76,8,25,37,6,7.63888888888889,32.6388888888889,50,9.72222222222222,47.2222222222222,2.08333333333333,15.2777777777778,24.3055555555556,5.55555555555556,52.7777777777778,5.55555555555556,17.3611111111111,25.6944444444444,4.16666666666667
"E00021302",231,26,37,133,35,129,13,17,75,24,102,13,20,58,11,11.2554112554113,16.017316017316,57.5757575757576,15.1515151515152,55.8441558441558,5.62770562770563,7.35930735930736,32.4675324675325,10.3896103896104,44.1558441558442,5.62770562770563,8.65800865800866,25.1082251082251,4.76190476190476
"E00021303",140,18,40,74,8,92,8,23,56,5,48,10,17,18,3,12.8571428571429,28.5714285714286,52.8571428571429,5.71428571428571,65.7142857142857,5.71428571428571,16.4285714285714,40,3.57142857142857,34.2857142857143,7.14285714285714,12.1428571428571,12.8571428571429,2.14285714285714
"E00021304",175,21,34,95,25,86,9,20,43,14,89,12,14,52,11,12,19.4285714285714,54.2857142857143,14.2857142857143,49.1428571428571,5.14285714285714,11.4285714285714,24.5714285714286,8,50.8571428571429,6.85714285714286,8,29.7142857142857,6.28571428571429
"E00021305",158,13,21,90,34,81,5,9,43,24,77,8,12,47,10,8.22784810126582,13.2911392405063,56.9620253164557,21.5189873417722,51.2658227848101,3.16455696202532,5.69620253164557,27.2151898734177,15.1898734177215,48.7341772151899,5.06329113924051,7.59493670886076,29.746835443038,6.32911392405063
"E00021306",162,11,15,98,38,90,8,5,48,29,72,3,10,50,9,6.79012345679012,9.25925925925926,60.4938271604938,23.4567901234568,55.5555555555556,4.93827160493827,3.08641975308642,29.6296296296296,17.9012345679012,44.4444444444444,1.85185185185185,6.17283950617284,30.8641975308642,5.55555555555556
"E00021307",309,26,37,197,49,163,8,15,107,33,146,18,22,90,16,8.41423948220065,11.9741100323625,63.7540453074434,15.8576051779935,52.7508090614887,2.58899676375405,4.85436893203883,34.6278317152104,10.6796116504854,47.2491909385113,5.8252427184466,7.11974110032362,29.126213592233,5.17799352750809
"E00021308",206,26,29,122,29,105,13,15,57,20,101,13,14,65,9,12.621359223301,14.0776699029126,59.2233009708738,14.0776699029126,50.9708737864078,6.31067961165049,7.28155339805825,27.6699029126214,9.70873786407767,49.0291262135922,6.31067961165049,6.79611650485437,31.5533980582524,4.36893203883495
"E00021309",159,3,15,109,32,85,1,6,55,23,74,2,9,54,9,1.88679245283019,9.43396226415094,68.5534591194968,20.125786163522,53.4591194968553,0.628930817610063,3.77358490566038,34.5911949685535,14.4654088050314,46.5408805031447,1.25786163522013,5.66037735849057,33.9622641509434,5.66037735849057
"E00021310",108,13,21,66,8,48,4,8,33,3,60,9,13,33,5,12.037037037037,19.4444444444444,61.1111111111111,7.40740740740741,44.4444444444444,3.7037037037037,7.40740740740741,30.5555555555556,2.77777777777778,55.5555555555556,8.33333333333333,12.037037037037,30.5555555555556,4.62962962962963
"E00021311",131,12,37,65,17,80,6,22,42,10,51,6,15,23,7,9.16030534351145,28.2442748091603,49.618320610687,12.9770992366412,61.0687022900763,4.58015267175572,16.793893129771,32.0610687022901,7.63358778625954,38.9312977099237,4.58015267175572,11.4503816793893,17.5572519083969,5.34351145038168
"E00021312",156,13,25,98,20,76,2,8,51,15,80,11,17,47,5,8.33333333333333,16.025641025641,62.8205128205128,12.8205128205128,48.7179487179487,1.28205128205128,5.12820512820513,32.6923076923077,9.61538461538462,51.2820512820513,7.05128205128205,10.8974358974359,30.1282051282051,3.2051282051282
"E00021313",272,28,32,170,42,144,10,14,93,27,128,18,18,77,15,10.2941176470588,11.7647058823529,62.5,15.4411764705882,52.9411764705882,3.67647058823529,5.14705882352941,34.1911764705882,9.92647058823529,47.0588235294118,6.61764705882353,6.61764705882353,28.3088235294118,5.51470588235294
"E00021314",225,13,42,129,41,107,3,13,68,23,118,10,29,61,18,5.77777777777778,18.6666666666667,57.3333333333333,18.2222222222222,47.5555555555556,1.33333333333333,5.77777777777778,30.2222222222222,10.2222222222222,52.4444444444444,4.44444444444444,12.8888888888889,27.1111111111111,8
"E00021315",35,7,5,21,2,20,3,2,14,1,15,4,3,7,1,20,14.2857142857143,60,5.71428571428571,57.1428571428571,8.57142857142857,5.71428571428571,40,2.85714285714286,42.8571428571429,11.4285714285714,8.57142857142857,20,2.85714285714286
"E00021316",123,12,31,72,8,61,8,18,31,4,62,4,13,41,4,9.75609756097561,25.2032520325203,58.5365853658537,6.50406504065041,49.5934959349593,6.50406504065041,14.6341463414634,25.2032520325203,3.2520325203252,50.4065040650407,3.2520325203252,10.5691056910569,33.3333333333333,3.2520325203252
"E00021317",190,13,24,101,52,98,2,6,56,34,92,11,18,45,18,6.8421052631579,12.6315789473684,53.1578947368421,27.3684210526316,51.5789473684211,1.05263157894737,3.15789473684211,29.4736842105263,17.8947368421053,48.4210526315789,5.78947368421053,9.47368421052632,23.6842105263158,9.47368421052632
"E00021318",155,8,30,101,16,75,1,9,52,13,80,7,21,49,3,5.16129032258065,19.3548387096774,65.1612903225806,10.3225806451613,48.3870967741936,0.645161290322581,5.80645161290323,33.5483870967742,8.38709677419355,51.6129032258064,4.51612903225806,13.5483870967742,31.6129032258064,1.93548387096774
"E00021319",140,13,26,78,23,77,5,13,43,16,63,8,13,35,7,9.28571428571429,18.5714285714286,55.7142857142857,16.4285714285714,55,3.57142857142857,9.28571428571429,30.7142857142857,11.4285714285714,45,5.71428571428571,9.28571428571429,25,5
"E00021320",146,15,30,75,26,70,3,9,43,15,76,12,21,32,11,10.2739726027397,20.5479452054795,51.3698630136986,17.8082191780822,47.945205479452,2.05479452054794,6.16438356164384,29.4520547945205,10.2739726027397,52.0547945205479,8.21917808219178,14.3835616438356,21.9178082191781,7.53424657534247
"E00021321",151,16,18,90,27,77,8,9,44,16,74,8,9,46,11,10.5960264900662,11.9205298013245,59.6026490066225,17.8807947019868,50.9933774834437,5.29801324503311,5.96026490066225,29.1390728476821,10.5960264900662,49.0066225165563,5.29801324503311,5.96026490066225,30.4635761589404,7.28476821192053
"E00021322",124,14,27,71,12,63,2,15,41,5,61,12,12,30,7,11.2903225806452,21.7741935483871,57.258064516129,9.67741935483871,50.8064516129032,1.61290322580645,12.0967741935484,33.0645161290323,4.03225806451613,49.1935483870968,9.67741935483871,9.67741935483871,24.1935483870968,5.64516129032258
"E00021323",128,24,37,57,10,72,16,19,31,6,56,8,18,26,4,18.75,28.90625,44.53125,7.8125,56.25,12.5,14.84375,24.21875,4.6875,43.75,6.25,14.0625,20.3125,3.125
"E00021324",209,5,15,150,39,102,3,1,72,26,107,2,14,78,13,2.39234449760766,7.17703349282297,71.7703349282297,18.6602870813397,48.8038277511962,1.43540669856459,0.478468899521531,34.4497607655502,12.4401913875598,51.1961722488038,0.956937799043062,6.69856459330144,37.3205741626794,6.2200956937799
"E00021325",180,8,29,108,35,96,4,14,53,25,84,4,15,55,10,4.44444444444444,16.1111111111111,60,19.4444444444444,53.3333333333333,2.22222222222222,7.77777777777778,29.4444444444444,13.8888888888889,46.6666666666667,2.22222222222222,8.33333333333333,30.5555555555556,5.55555555555556
"E00021326",156,27,44,69,16,83,16,24,37,6,73,11,20,32,10,17.3076923076923,28.2051282051282,44.2307692307692,10.2564102564103,53.2051282051282,10.2564102564103,15.3846153846154,23.7179487179487,3.84615384615385,46.7948717948718,7.05128205128205,12.8205128205128,20.5128205128205,6.41025641025641
"E00021327",229,18,31,139,41,117,5,7,75,30,112,13,24,64,11,7.86026200873363,13.5371179039301,60.6986899563319,17.9039301310044,51.0917030567686,2.18340611353712,3.05676855895197,32.7510917030568,13.1004366812227,48.9082969432314,5.67685589519651,10.4803493449782,27.9475982532751,4.80349344978166
"E00021328",182,26,49,92,15,101,15,28,48,10,81,11,21,44,5,14.2857142857143,26.9230769230769,50.5494505494505,8.24175824175824,55.4945054945055,8.24175824175824,15.3846153846154,26.3736263736264,5.49450549450549,44.5054945054945,6.04395604395604,11.5384615384615,24.1758241758242,2.74725274725275
"E00021329",147,28,34,73,12,84,11,20,44,9,63,17,14,29,3,19.047619047619,23.1292517006803,49.6598639455782,8.16326530612245,57.1428571428571,7.48299319727891,13.6054421768707,29.9319727891156,6.12244897959184,42.8571428571429,11.5646258503401,9.52380952380952,19.7278911564626,2.04081632653061
"E00021330",135,14,28,85,8,81,9,19,47,6,54,5,9,38,2,10.3703703703704,20.7407407407407,62.962962962963,5.92592592592593,60,6.66666666666667,14.0740740740741,34.8148148148148,4.44444444444444,40,3.7037037037037,6.66666666666667,28.1481481481481,1.48148148148148
"E00021331",101,18,20,55,8,56,10,9,30,7,45,8,11,25,1,17.8217821782178,19.8019801980198,54.4554455445545,7.92079207920792,55.4455445544555,9.9009900990099,8.91089108910891,29.7029702970297,6.93069306930693,44.5544554455446,7.92079207920792,10.8910891089109,24.7524752475248,0.99009900990099
"E00021332",142,22,58,49,13,85,9,33,30,13,57,13,25,19,0,15.4929577464789,40.8450704225352,34.5070422535211,9.15492957746479,59.8591549295775,6.33802816901408,23.2394366197183,21.1267605633803,9.15492957746479,40.1408450704225,9.15492957746479,17.6056338028169,13.3802816901408,0
"E00021333",116,8,33,69,6,77,5,24,44,4,39,3,9,25,2,6.89655172413793,28.448275862069,59.4827586206897,5.17241379310345,66.3793103448276,4.31034482758621,20.6896551724138,37.9310344827586,3.44827586206897,33.6206896551724,2.58620689655172,7.75862068965517,21.551724137931,1.72413793103448
"E00021334",153,13,39,90,11,93,7,22,56,8,60,6,17,34,3,8.49673202614379,25.4901960784314,58.8235294117647,7.18954248366013,60.7843137254902,4.57516339869281,14.3790849673203,36.6013071895425,5.22875816993464,39.2156862745098,3.92156862745098,11.1111111111111,22.2222222222222,1.96078431372549
"E00021335",197,21,51,105,20,106,8,25,63,10,91,13,26,42,10,10.6598984771574,25.8883248730964,53.2994923857868,10.1522842639594,53.8071065989848,4.06091370558376,12.6903553299492,31.9796954314721,5.0761421319797,46.1928934010152,6.5989847715736,13.1979695431472,21.3197969543147,5.0761421319797
"E00021336",100,15,26,44,15,51,6,14,23,8,49,9,12,21,7,15,26,44,15,51,6,14,23,8,49,9,12,21,7
"E00021337",114,16,42,52,4,70,7,24,36,3,44,9,18,16,1,14.0350877192982,36.8421052631579,45.6140350877193,3.50877192982456,61.4035087719298,6.14035087719298,21.0526315789474,31.5789473684211,2.63157894736842,38.5964912280702,7.89473684210526,15.7894736842105,14.0350877192982,0.87719298245614
"E00021338",130,23,45,54,8,82,15,32,30,5,48,8,13,24,3,17.6923076923077,34.6153846153846,41.5384615384615,6.15384615384615,63.0769230769231,11.5384615384615,24.6153846153846,23.0769230769231,3.84615384615385,36.9230769230769,6.15384615384615,10,18.4615384615385,2.30769230769231
"E00021339",165,11,22,113,19,80,5,14,52,9,85,6,8,61,10,6.66666666666667,13.3333333333333,68.4848484848485,11.5151515151515,48.4848484848485,3.03030303030303,8.48484848484849,31.5151515151515,5.45454545454545,51.5151515151515,3.63636363636364,4.84848484848485,36.969696969697,6.06060606060606
"E00021340",202,12,26,129,35,114,6,15,70,23,88,6,11,59,12,5.94059405940594,12.8712871287129,63.8613861386139,17.3267326732673,56.4356435643564,2.97029702970297,7.42574257425743,34.6534653465347,11.3861386138614,43.5643564356436,2.97029702970297,5.44554455445545,29.2079207920792,5.94059405940594
"E00021342",107,7,26,62,12,63,2,17,35,9,44,5,9,27,3,6.54205607476635,24.2990654205607,57.9439252336449,11.214953271028,58.8785046728972,1.86915887850467,15.8878504672897,32.7102803738318,8.41121495327103,41.1214953271028,4.67289719626168,8.41121495327103,25.2336448598131,2.80373831775701
"E00021344",154,21,50,78,5,95,10,33,48,4,59,11,17,30,1,13.6363636363636,32.4675324675325,50.6493506493506,3.24675324675325,61.6883116883117,6.49350649350649,21.4285714285714,31.1688311688312,2.5974025974026,38.3116883116883,7.14285714285714,11.038961038961,19.4805194805195,0.649350649350649
"E00021345",126,14,41,62,9,73,6,22,39,6,53,8,19,23,3,11.1111111111111,32.5396825396825,49.2063492063492,7.14285714285714,57.9365079365079,4.76190476190476,17.4603174603175,30.952380952381,4.76190476190476,42.0634920634921,6.34920634920635,15.0793650793651,18.2539682539683,2.38095238095238
"E00021346",106,19,29,53,5,57,9,17,28,3,49,10,12,25,2,17.9245283018868,27.3584905660377,50,4.71698113207547,53.7735849056604,8.49056603773585,16.0377358490566,26.4150943396226,2.83018867924528,46.2264150943396,9.43396226415094,11.3207547169811,23.5849056603774,1.88679245283019
"E00021347",133,17,45,59,12,83,10,33,31,9,50,7,12,28,3,12.781954887218,33.8345864661654,44.3609022556391,9.02255639097744,62.406015037594,7.5187969924812,24.812030075188,23.3082706766917,6.76691729323308,37.593984962406,5.26315789473684,9.02255639097744,21.0526315789474,2.25563909774436
"E00021349",144,23,38,72,11,92,13,19,51,9,52,10,19,21,2,15.9722222222222,26.3888888888889,50,7.63888888888889,63.8888888888889,9.02777777777778,13.1944444444444,35.4166666666667,6.25,36.1111111111111,6.94444444444444,13.1944444444444,14.5833333333333,1.38888888888889
"E00021350",117,15,26,68,8,71,10,17,38,6,46,5,9,30,2,12.8205128205128,22.2222222222222,58.1196581196581,6.83760683760684,60.6837606837607,8.54700854700855,14.5299145299145,32.4786324786325,5.12820512820513,39.3162393162393,4.27350427350427,7.69230769230769,25.6410256410256,1.70940170940171
"E00021351",131,19,50,51,11,93,14,39,31,9,38,5,11,20,2,14.5038167938931,38.1679389312977,38.9312977099237,8.3969465648855,70.9923664122137,10.6870229007634,29.7709923664122,23.6641221374046,6.87022900763359,29.0076335877863,3.81679389312977,8.3969465648855,15.2671755725191,1.52671755725191
"E00021352",131,16,32,70,13,72,6,16,42,8,59,10,16,28,5,12.2137404580153,24.4274809160305,53.4351145038168,9.9236641221374,54.9618320610687,4.58015267175572,12.2137404580153,32.0610687022901,6.10687022900763,45.0381679389313,7.63358778625954,12.2137404580153,21.3740458015267,3.81679389312977
"E00021353",95,15,26,47,7,63,9,20,30,4,32,6,6,17,3,15.7894736842105,27.3684210526316,49.4736842105263,7.36842105263158,66.3157894736842,9.47368421052632,21.0526315789474,31.5789473684211,4.21052631578947,33.6842105263158,6.31578947368421,6.31578947368421,17.8947368421053,3.15789473684211
"E00021354",168,19,42,93,14,100,10,31,50,9,68,9,11,43,5,11.3095238095238,25,55.3571428571429,8.33333333333333,59.5238095238095,5.95238095238095,18.452380952381,29.7619047619048,5.35714285714286,40.4761904761905,5.35714285714286,6.54761904761905,25.5952380952381,2.97619047619048
"E00021355",174,4,15,128,27,96,2,9,70,15,78,2,6,58,12,2.29885057471264,8.62068965517241,73.5632183908046,15.5172413793103,55.1724137931034,1.14942528735632,5.17241379310345,40.2298850574713,8.62068965517241,44.8275862068966,1.14942528735632,3.44827586206897,33.3333333333333,6.89655172413793
"E00021357",102,11,33,48,10,69,4,24,33,8,33,7,9,15,2,10.7843137254902,32.3529411764706,47.0588235294118,9.80392156862745,67.6470588235294,3.92156862745098,23.5294117647059,32.3529411764706,7.84313725490196,32.3529411764706,6.86274509803922,8.82352941176471,14.7058823529412,1.96078431372549
"E00021359",131,10,35,75,11,79,3,23,45,8,52,7,12,30,3,7.63358778625954,26.7175572519084,57.2519083969466,8.3969465648855,60.3053435114504,2.29007633587786,17.5572519083969,34.3511450381679,6.10687022900763,39.6946564885496,5.34351145038168,9.16030534351145,22.9007633587786,2.29007633587786
"E00021360",141,30,41,61,9,89,19,28,36,6,52,11,13,25,3,21.2765957446809,29.0780141843972,43.2624113475177,6.38297872340426,63.1205673758865,13.4751773049645,19.8581560283688,25.531914893617,4.25531914893617,36.8794326241135,7.80141843971631,9.21985815602837,17.7304964539007,2.12765957446809
"E00021361",109,16,23,60,10,63,7,10,38,8,46,9,13,22,2,14.6788990825688,21.1009174311927,55.045871559633,9.1743119266055,57.7981651376147,6.42201834862385,9.1743119266055,34.8623853211009,7.3394495412844,42.2018348623853,8.25688073394496,11.9266055045872,20.1834862385321,1.8348623853211
"E00021363",120,20,32,60,8,65,9,14,35,7,55,11,18,25,1,16.6666666666667,26.6666666666667,50,6.66666666666667,54.1666666666667,7.5,11.6666666666667,29.1666666666667,5.83333333333333,45.8333333333333,9.16666666666667,15,20.8333333333333,0.833333333333333
"E00021364",204,19,55,117,13,123,15,26,71,11,81,4,29,46,2,9.31372549019608,26.9607843137255,57.3529411764706,6.37254901960784,60.2941176470588,7.35294117647059,12.7450980392157,34.8039215686275,5.3921568627451,39.7058823529412,1.96078431372549,14.2156862745098,22.5490196078431,0.980392156862745
"E00021365",135,13,25,80,17,75,3,15,47,10,60,10,10,33,7,9.62962962962963,18.5185185185185,59.2592592592593,12.5925925925926,55.5555555555556,2.22222222222222,11.1111111111111,34.8148148148148,7.40740740740741,44.4444444444444,7.40740740740741,7.40740740740741,24.4444444444444,5.18518518518519
"E00021366",121,20,42,51,8,73,9,24,34,6,48,11,18,17,2,16.5289256198347,34.7107438016529,42.1487603305785,6.61157024793388,60.3305785123967,7.43801652892562,19.8347107438017,28.099173553719,4.95867768595041,39.6694214876033,9.09090909090909,14.8760330578512,14.0495867768595,1.65289256198347
"E00021367",104,12,23,56,13,59,7,14,28,10,45,5,9,28,3,11.5384615384615,22.1153846153846,53.8461538461538,12.5,56.7307692307692,6.73076923076923,13.4615384615385,26.9230769230769,9.61538461538462,43.2692307692308,4.80769230769231,8.65384615384615,26.9230769230769,2.88461538461538
"E00021368",143,19,44,70,10,96,15,29,43,9,47,4,15,27,1,13.2867132867133,30.7692307692308,48.951048951049,6.99300699300699,67.1328671328671,10.4895104895105,20.2797202797203,30.0699300699301,6.29370629370629,32.8671328671329,2.7972027972028,10.4895104895105,18.8811188811189,0.699300699300699
"E00021369",69,9,23,32,5,41,4,16,16,5,28,5,7,16,0,13.0434782608696,33.3333333333333,46.3768115942029,7.2463768115942,59.4202898550725,5.79710144927536,23.1884057971014,23.1884057971014,7.2463768115942,40.5797101449275,7.2463768115942,10.1449275362319,23.1884057971014,0
"E00021370",171,21,51,86,13,90,6,25,49,10,81,15,26,37,3,12.280701754386,29.8245614035088,50.2923976608187,7.60233918128655,52.6315789473684,3.50877192982456,14.6198830409357,28.6549707602339,5.84795321637427,47.3684210526316,8.7719298245614,15.2046783625731,21.6374269005848,1.75438596491228
"E00021371",45,6,20,17,2,29,3,16,9,1,16,3,4,8,1,13.3333333333333,44.4444444444444,37.7777777777778,4.44444444444444,64.4444444444444,6.66666666666667,35.5555555555556,20,2.22222222222222,35.5555555555556,6.66666666666667,8.88888888888889,17.7777777777778,2.22222222222222
"E00021372",161,10,32,98,21,88,2,17,55,14,73,8,15,43,7,6.2111801242236,19.8757763975155,60.8695652173913,13.0434782608696,54.6583850931677,1.24223602484472,10.5590062111801,34.1614906832298,8.69565217391304,45.3416149068323,4.96894409937888,9.3167701863354,26.7080745341615,4.34782608695652
"E00021374",120,23,41,49,7,73,15,28,28,2,47,8,13,21,5,19.1666666666667,34.1666666666667,40.8333333333333,5.83333333333333,60.8333333333333,12.5,23.3333333333333,23.3333333333333,1.66666666666667,39.1666666666667,6.66666666666667,10.8333333333333,17.5,4.16666666666667
"E00021375",121,18,40,52,11,65,7,22,28,8,56,11,18,24,3,14.8760330578512,33.0578512396694,42.9752066115703,9.09090909090909,53.7190082644628,5.78512396694215,18.1818181818182,23.1404958677686,6.61157024793388,46.2809917355372,9.09090909090909,14.8760330578512,19.8347107438017,2.47933884297521
"E00021376",110,20,34,48,8,71,14,26,27,4,39,6,8,21,4,18.1818181818182,30.9090909090909,43.6363636363636,7.27272727272727,64.5454545454545,12.7272727272727,23.6363636363636,24.5454545454545,3.63636363636364,35.4545454545455,5.45454545454545,7.27272727272727,19.0909090909091,3.63636363636364
"E00021377",234,25,47,136,26,131,10,18,84,19,103,15,29,52,7,10.6837606837607,20.0854700854701,58.1196581196581,11.1111111111111,55.982905982906,4.27350427350427,7.69230769230769,35.8974358974359,8.11965811965812,44.017094017094,6.41025641025641,12.3931623931624,22.2222222222222,2.99145299145299
"E00021378",173,18,43,97,15,106,7,27,61,11,67,11,16,36,4,10.4046242774566,24.8554913294798,56.0693641618497,8.67052023121387,61.271676300578,4.04624277456647,15.606936416185,35.2601156069364,6.35838150289017,38.728323699422,6.35838150289017,9.2485549132948,20.8092485549133,2.3121387283237
"E00021379",116,9,24,72,11,68,3,14,41,10,48,6,10,31,1,7.75862068965517,20.6896551724138,62.0689655172414,9.48275862068965,58.6206896551724,2.58620689655172,12.0689655172414,35.3448275862069,8.62068965517241,41.3793103448276,5.17241379310345,8.62068965517241,26.7241379310345,0.862068965517241
"E00021380",98,7,15,58,18,61,3,11,33,14,37,4,4,25,4,7.14285714285714,15.3061224489796,59.1836734693878,18.3673469387755,62.2448979591837,3.06122448979592,11.2244897959184,33.6734693877551,14.2857142857143,37.7551020408163,4.08163265306122,4.08163265306122,25.5102040816327,4.08163265306122
"E00021381",125,13,35,60,17,74,8,21,36,9,51,5,14,24,8,10.4,28,48,13.6,59.2,6.4,16.8,28.8,7.2,40.8,4,11.2,19.2,6.4
"E00021382",111,16,42,46,7,63,7,25,24,7,48,9,17,22,0,14.4144144144144,37.8378378378378,41.4414414414414,6.30630630630631,56.7567567567568,6.30630630630631,22.5225225225225,21.6216216216216,6.30630630630631,43.2432432432432,8.10810810810811,15.3153153153153,19.8198198198198,0
"E00021383",150,18,32,87,13,80,11,19,45,5,70,7,13,42,8,12,21.3333333333333,58,8.66666666666667,53.3333333333333,7.33333333333333,12.6666666666667,30,3.33333333333333,46.6666666666667,4.66666666666667,8.66666666666667,28,5.33333333333333
"E00021384",171,8,12,103,48,106,4,4,65,33,65,4,8,38,15,4.67836257309941,7.01754385964912,60.233918128655,28.0701754385965,61.9883040935673,2.33918128654971,2.33918128654971,38.0116959064327,19.2982456140351,38.0116959064327,2.33918128654971,4.67836257309941,22.2222222222222,8.7719298245614
"E00021385",207,10,35,131,31,121,4,21,77,19,86,6,14,54,12,4.83091787439614,16.9082125603865,63.2850241545894,14.975845410628,58.4541062801932,1.93236714975845,10.1449275362319,37.1980676328502,9.17874396135266,41.5458937198068,2.89855072463768,6.76328502415459,26.0869565217391,5.79710144927536
"E00021386",120,11,37,64,8,73,5,22,39,7,47,6,15,25,1,9.16666666666667,30.8333333333333,53.3333333333333,6.66666666666667,60.8333333333333,4.16666666666667,18.3333333333333,32.5,5.83333333333333,39.1666666666667,5,12.5,20.8333333333333,0.833333333333333
"E00021387",256,20,51,159,26,139,9,27,82,21,117,11,24,77,5,7.8125,19.921875,62.109375,10.15625,54.296875,3.515625,10.546875,32.03125,8.203125,45.703125,4.296875,9.375,30.078125,1.953125
"E00021388",119,13,31,59,16,67,7,17,31,12,52,6,14,28,4,10.9243697478992,26.0504201680672,49.5798319327731,13.4453781512605,56.3025210084034,5.88235294117647,14.2857142857143,26.0504201680672,10.0840336134454,43.6974789915966,5.04201680672269,11.7647058823529,23.5294117647059,3.36134453781513
"E00021391",132,9,41,75,7,80,7,26,42,5,52,2,15,33,2,6.81818181818182,31.0606060606061,56.8181818181818,5.3030303030303,60.6060606060606,5.3030303030303,19.6969696969697,31.8181818181818,3.78787878787879,39.3939393939394,1.51515151515152,11.3636363636364,25,1.51515151515152
"E00021392",185,16,40,112,17,103,8,19,65,11,82,8,21,47,6,8.64864864864865,21.6216216216216,60.5405405405405,9.18918918918919,55.6756756756757,4.32432432432432,10.2702702702703,35.1351351351351,5.94594594594595,44.3243243243243,4.32432432432432,11.3513513513514,25.4054054054054,3.24324324324324
"E00021393",132,22,47,57,6,79,10,28,38,3,53,12,19,19,3,16.6666666666667,35.6060606060606,43.1818181818182,4.54545454545455,59.8484848484849,7.57575757575758,21.2121212121212,28.7878787878788,2.27272727272727,40.1515151515151,9.09090909090909,14.3939393939394,14.3939393939394,2.27272727272727
"E00021394",108,12,33,56,7,59,1,16,36,6,49,11,17,20,1,11.1111111111111,30.5555555555556,51.8518518518518,6.48148148148148,54.6296296296296,0.925925925925926,14.8148148148148,33.3333333333333,5.55555555555556,45.3703703703704,10.1851851851852,15.7407407407407,18.5185185185185,0.925925925925926
"E00021395",90,11,25,46,8,62,7,17,31,7,28,4,8,15,1,12.2222222222222,27.7777777777778,51.1111111111111,8.88888888888889,68.8888888888889,7.77777777777778,18.8888888888889,34.4444444444444,7.77777777777778,31.1111111111111,4.44444444444444,8.88888888888889,16.6666666666667,1.11111111111111
"E00021396",120,15,37,58,10,61,3,19,36,3,59,12,18,22,7,12.5,30.8333333333333,48.3333333333333,8.33333333333333,50.8333333333333,2.5,15.8333333333333,30,2.5,49.1666666666667,10,15,18.3333333333333,5.83333333333333
"E00021397",154,19,48,72,15,83,7,23,40,13,71,12,25,32,2,12.3376623376623,31.1688311688312,46.7532467532467,9.74025974025974,53.8961038961039,4.54545454545455,14.9350649350649,25.974025974026,8.44155844155844,46.1038961038961,7.79220779220779,16.2337662337662,20.7792207792208,1.2987012987013
"E00021398",198,25,43,111,19,105,11,25,55,14,93,14,18,56,5,12.6262626262626,21.7171717171717,56.0606060606061,9.5959595959596,53.030303030303,5.55555555555556,12.6262626262626,27.7777777777778,7.07070707070707,46.969696969697,7.07070707070707,9.09090909090909,28.2828282828283,2.52525252525253
"E00021399",192,9,12,99,72,118,5,8,58,47,74,4,4,41,25,4.6875,6.25,51.5625,37.5,61.4583333333333,2.60416666666667,4.16666666666667,30.2083333333333,24.4791666666667,38.5416666666667,2.08333333333333,2.08333333333333,21.3541666666667,13.0208333333333
"E00021400",147,10,36,86,15,80,3,19,48,10,67,7,17,38,5,6.80272108843537,24.4897959183673,58.5034013605442,10.2040816326531,54.421768707483,2.04081632653061,12.9251700680272,32.6530612244898,6.80272108843537,45.578231292517,4.76190476190476,11.5646258503401,25.8503401360544,3.40136054421769
"E00021402",119,7,33,66,13,74,0,19,45,10,45,7,14,21,3,5.88235294117647,27.7310924369748,55.4621848739496,10.9243697478992,62.1848739495798,0,15.9663865546218,37.8151260504202,8.40336134453782,37.8151260504202,5.88235294117647,11.7647058823529,17.6470588235294,2.52100840336134
"E00021404",203,5,13,110,75,134,3,9,67,55,69,2,4,43,20,2.46305418719212,6.40394088669951,54.1871921182266,36.9458128078818,66.0098522167488,1.47783251231527,4.43349753694581,33.0049261083744,27.0935960591133,33.9901477832512,0.985221674876847,1.97044334975369,21.1822660098522,9.85221674876847
"E00021405",195,18,50,106,21,117,7,31,65,14,78,11,19,41,7,9.23076923076923,25.6410256410256,54.3589743589744,10.7692307692308,60,3.58974358974359,15.8974358974359,33.3333333333333,7.17948717948718,40,5.64102564102564,9.74358974358974,21.025641025641,3.58974358974359
"E00021406",142,14,38,75,15,77,5,22,43,7,65,9,16,32,8,9.85915492957746,26.7605633802817,52.8169014084507,10.5633802816901,54.2253521126761,3.52112676056338,15.4929577464789,30.2816901408451,4.92957746478873,45.7746478873239,6.33802816901408,11.2676056338028,22.5352112676056,5.63380281690141
"E00021407",149,22,46,70,11,85,14,26,38,7,64,8,20,32,4,14.7651006711409,30.8724832214765,46.9798657718121,7.38255033557047,57.0469798657718,9.39597315436242,17.4496644295302,25.503355704698,4.69798657718121,42.9530201342282,5.36912751677852,13.4228187919463,21.4765100671141,2.68456375838926
"E00021408",241,7,23,139,72,139,3,7,87,42,102,4,16,52,30,2.9045643153527,9.54356846473029,57.6763485477178,29.8755186721992,57.6763485477178,1.2448132780083,2.9045643153527,36.0995850622407,17.4273858921162,42.3236514522822,1.6597510373444,6.63900414937759,21.5767634854772,12.448132780083
"E00021409",219,4,7,126,82,133,2,1,72,58,86,2,6,54,24,1.82648401826484,3.19634703196347,57.5342465753425,37.4429223744292,60.7305936073059,0.91324200913242,0.45662100456621,32.8767123287671,26.4840182648402,39.2694063926941,0.91324200913242,2.73972602739726,24.6575342465753,10.958904109589
"E00021410",155,22,29,82,22,81,9,14,43,15,74,13,15,39,7,14.1935483870968,18.7096774193548,52.9032258064516,14.1935483870968,52.258064516129,5.80645161290323,9.03225806451613,27.741935483871,9.67741935483871,47.741935483871,8.38709677419355,9.67741935483871,25.1612903225806,4.51612903225806
"E00021411",179,15,32,111,21,108,9,17,70,12,71,6,15,41,9,8.37988826815642,17.877094972067,62.0111731843575,11.731843575419,60.3351955307263,5.02793296089385,9.49720670391061,39.1061452513966,6.70391061452514,39.6648044692737,3.35195530726257,8.37988826815642,22.9050279329609,5.02793296089385
"E00021412",183,14,41,110,18,102,5,25,60,12,81,9,16,50,6,7.65027322404372,22.4043715846995,60.1092896174863,9.83606557377049,55.7377049180328,2.73224043715847,13.6612021857924,32.7868852459016,6.55737704918033,44.2622950819672,4.91803278688525,8.7431693989071,27.3224043715847,3.27868852459016
"E00021413",141,13,46,67,15,82,9,27,39,7,59,4,19,28,8,9.21985815602837,32.6241134751773,47.5177304964539,10.6382978723404,58.1560283687943,6.38297872340426,19.1489361702128,27.6595744680851,4.9645390070922,41.8439716312057,2.83687943262411,13.4751773049645,19.8581560283688,5.67375886524823
"E00021414",122,14,45,55,8,84,7,33,39,5,38,7,12,16,3,11.4754098360656,36.8852459016393,45.0819672131148,6.55737704918033,68.8524590163934,5.73770491803279,27.0491803278689,31.9672131147541,4.0983606557377,31.1475409836066,5.73770491803279,9.83606557377049,13.1147540983607,2.45901639344262
"E00021415",136,16,45,66,9,73,5,21,41,6,63,11,24,25,3,11.7647058823529,33.0882352941176,48.5294117647059,6.61764705882353,53.6764705882353,3.67647058823529,15.4411764705882,30.1470588235294,4.41176470588235,46.3235294117647,8.08823529411765,17.6470588235294,18.3823529411765,2.20588235294118
"E00021416",150,13,33,88,16,80,3,16,48,13,70,10,17,40,3,8.66666666666667,22,58.6666666666667,10.6666666666667,53.3333333333333,2,10.6666666666667,32,8.66666666666667,46.6666666666667,6.66666666666667,11.3333333333333,26.6666666666667,2
"E00021417",122,11,25,75,11,69,9,13,40,7,53,2,12,35,4,9.01639344262295,20.4918032786885,61.4754098360656,9.01639344262295,56.5573770491803,7.37704918032787,10.655737704918,32.7868852459016,5.73770491803279,43.4426229508197,1.63934426229508,9.83606557377049,28.6885245901639,3.27868852459016
"E00021418",165,5,6,84,70,99,2,1,48,48,66,3,5,36,22,3.03030303030303,3.63636363636364,50.9090909090909,42.4242424242424,60,1.21212121212121,0.606060606060606,29.0909090909091,29.0909090909091,40,1.81818181818182,3.03030303030303,21.8181818181818,13.3333333333333
"E00021419",122,9,43,62,8,75,3,27,37,8,47,6,16,25,0,7.37704918032787,35.2459016393443,50.8196721311475,6.55737704918033,61.4754098360656,2.45901639344262,22.1311475409836,30.327868852459,6.55737704918033,38.5245901639344,4.91803278688525,13.1147540983607,20.4918032786885,0
"E00021420",144,6,16,75,47,83,1,7,42,33,61,5,9,33,14,4.16666666666667,11.1111111111111,52.0833333333333,32.6388888888889,57.6388888888889,0.694444444444444,4.86111111111111,29.1666666666667,22.9166666666667,42.3611111111111,3.47222222222222,6.25,22.9166666666667,9.72222222222222
"E00021421",174,15,40,103,16,105,7,28,59,11,69,8,12,44,5,8.62068965517241,22.9885057471264,59.1954022988506,9.19540229885057,60.3448275862069,4.02298850574713,16.0919540229885,33.9080459770115,6.32183908045977,39.6551724137931,4.59770114942529,6.89655172413793,25.2873563218391,2.8735632183908
"E00021422",73,8,28,34,3,47,7,16,22,2,26,1,12,12,1,10.958904109589,38.3561643835616,46.5753424657534,4.10958904109589,64.3835616438356,9.58904109589041,21.9178082191781,30.1369863013699,2.73972602739726,35.6164383561644,1.36986301369863,16.4383561643836,16.4383561643836,1.36986301369863
"E00021423",136,10,49,67,10,90,4,35,45,6,46,6,14,22,4,7.35294117647059,36.0294117647059,49.2647058823529,7.35294117647059,66.1764705882353,2.94117647058824,25.7352941176471,33.0882352941176,4.41176470588235,33.8235294117647,4.41176470588235,10.2941176470588,16.1764705882353,2.94117647058824
"E00021424",170,4,11,93,62,95,1,3,49,42,75,3,8,44,20,2.35294117647059,6.47058823529412,54.7058823529412,36.4705882352941,55.8823529411765,0.588235294117647,1.76470588235294,28.8235294117647,24.7058823529412,44.1176470588235,1.76470588235294,4.70588235294118,25.8823529411765,11.7647058823529
"E00021425",191,8,11,98,74,106,3,4,51,48,85,5,7,47,26,4.18848167539267,5.75916230366492,51.3089005235602,38.7434554973822,55.4973821989529,1.57068062827225,2.09424083769634,26.7015706806283,25.130890052356,44.5026178010471,2.61780104712042,3.66492146596859,24.6073298429319,13.6125654450262
"E00021426",103,12,29,57,5,51,3,16,29,3,52,9,13,28,2,11.6504854368932,28.1553398058252,55.3398058252427,4.85436893203883,49.5145631067961,2.9126213592233,15.5339805825243,28.1553398058252,2.9126213592233,50.4854368932039,8.7378640776699,12.621359223301,27.1844660194175,1.94174757281553
"E00021427",178,11,10,73,84,102,6,7,34,55,76,5,3,39,29,6.17977528089888,5.61797752808989,41.0112359550562,47.1910112359551,57.3033707865169,3.37078651685393,3.93258426966292,19.1011235955056,30.8988764044944,42.6966292134831,2.80898876404494,1.68539325842697,21.9101123595506,16.2921348314607
"E00021428",160,17,42,85,16,92,8,20,52,12,68,9,22,33,4,10.625,26.25,53.125,10,57.5,5,12.5,32.5,7.5,42.5,5.625,13.75,20.625,2.5
"E00021429",72,8,12,42,10,41,4,7,23,7,31,4,5,19,3,11.1111111111111,16.6666666666667,58.3333333333333,13.8888888888889,56.9444444444444,5.55555555555556,9.72222222222222,31.9444444444444,9.72222222222222,43.0555555555556,5.55555555555556,6.94444444444444,26.3888888888889,4.16666666666667
"E00021430",104,11,26,52,15,74,6,22,34,12,30,5,4,18,3,10.5769230769231,25,50,14.4230769230769,71.1538461538462,5.76923076923077,21.1538461538462,32.6923076923077,11.5384615384615,28.8461538461538,4.80769230769231,3.84615384615385,17.3076923076923,2.88461538461538
"E00021431",120,17,27,66,10,78,10,17,44,7,42,7,10,22,3,14.1666666666667,22.5,55,8.33333333333333,65,8.33333333333333,14.1666666666667,36.6666666666667,5.83333333333333,35,5.83333333333333,8.33333333333333,18.3333333333333,2.5
"E00021432",121,9,39,64,9,74,7,20,40,7,47,2,19,24,2,7.43801652892562,32.2314049586777,52.8925619834711,7.43801652892562,61.1570247933884,5.78512396694215,16.5289256198347,33.0578512396694,5.78512396694215,38.8429752066116,1.65289256198347,15.702479338843,19.8347107438017,1.65289256198347
"E00021433",304,31,53,169,51,196,22,34,103,37,108,9,19,66,14,10.1973684210526,17.4342105263158,55.5921052631579,16.7763157894737,64.4736842105263,7.23684210526316,11.1842105263158,33.8815789473684,12.1710526315789,35.5263157894737,2.96052631578947,6.25,21.7105263157895,4.60526315789474
"E00021434",159,19,56,67,17,112,14,39,43,16,47,5,17,24,1,11.9496855345912,35.2201257861635,42.1383647798742,10.6918238993711,70.440251572327,8.80503144654088,24.5283018867925,27.0440251572327,10.062893081761,29.559748427673,3.14465408805031,10.6918238993711,15.0943396226415,0.628930817610063
"E00021437",115,14,21,67,13,68,4,13,43,8,47,10,8,24,5,12.1739130434783,18.2608695652174,58.2608695652174,11.304347826087,59.1304347826087,3.47826086956522,11.304347826087,37.3913043478261,6.95652173913043,40.8695652173913,8.69565217391304,6.95652173913043,20.8695652173913,4.34782608695652
"E00021438",68,9,26,27,6,38,5,16,14,3,30,4,10,13,3,13.2352941176471,38.2352941176471,39.7058823529412,8.82352941176471,55.8823529411765,7.35294117647059,23.5294117647059,20.5882352941176,4.41176470588235,44.1176470588235,5.88235294117647,14.7058823529412,19.1176470588235,4.41176470588235
"E00021439",59,13,15,30,1,33,5,9,18,1,26,8,6,12,0,22.0338983050847,25.4237288135593,50.8474576271186,1.69491525423729,55.9322033898305,8.47457627118644,15.2542372881356,30.5084745762712,1.69491525423729,44.0677966101695,13.5593220338983,10.1694915254237,20.3389830508475,0
"E00021440",165,32,45,81,7,114,20,34,56,4,51,12,11,25,3,19.3939393939394,27.2727272727273,49.0909090909091,4.24242424242424,69.0909090909091,12.1212121212121,20.6060606060606,33.9393939393939,2.42424242424242,30.9090909090909,7.27272727272727,6.66666666666667,15.1515151515152,1.81818181818182
"E00021441",185,5,36,112,32,84,3,15,48,18,101,2,21,64,14,2.7027027027027,19.4594594594595,60.5405405405405,17.2972972972973,45.4054054054054,1.62162162162162,8.10810810810811,25.9459459459459,9.72972972972973,54.5945945945946,1.08108108108108,11.3513513513514,34.5945945945946,7.56756756756757
"E00021442",139,14,23,81,21,79,6,15,44,14,60,8,8,37,7,10.0719424460432,16.5467625899281,58.273381294964,15.1079136690647,56.8345323741007,4.31654676258993,10.7913669064748,31.6546762589928,10.0719424460432,43.1654676258993,5.75539568345324,5.75539568345324,26.6187050359712,5.03597122302158
"E00021443",112,13,16,73,10,58,3,6,42,7,54,10,10,31,3,11.6071428571429,14.2857142857143,65.1785714285714,8.92857142857143,51.7857142857143,2.67857142857143,5.35714285714286,37.5,6.25,48.2142857142857,8.92857142857143,8.92857142857143,27.6785714285714,2.67857142857143
"E00021444",132,17,29,67,19,75,6,11,46,12,57,11,18,21,7,12.8787878787879,21.969696969697,50.7575757575758,14.3939393939394,56.8181818181818,4.54545454545455,8.33333333333333,34.8484848484849,9.09090909090909,43.1818181818182,8.33333333333333,13.6363636363636,15.9090909090909,5.3030303030303
"E00021445",135,39,46,46,4,89,19,35,34,1,46,20,11,12,3,28.8888888888889,34.0740740740741,34.0740740740741,2.96296296296296,65.9259259259259,14.0740740740741,25.9259259259259,25.1851851851852,0.740740740740741,34.0740740740741,14.8148148148148,8.14814814814815,8.88888888888889,2.22222222222222
"E00021446",120,17,40,50,13,82,11,31,30,10,38,6,9,20,3,14.1666666666667,33.3333333333333,41.6666666666667,10.8333333333333,68.3333333333333,9.16666666666667,25.8333333333333,25,8.33333333333333,31.6666666666667,5,7.5,16.6666666666667,2.5
"E00021447",185,14,11,126,34,104,5,2,73,24,81,9,9,53,10,7.56756756756757,5.94594594594595,68.1081081081081,18.3783783783784,56.2162162162162,2.7027027027027,1.08108108108108,39.4594594594595,12.972972972973,43.7837837837838,4.86486486486486,4.86486486486486,28.6486486486486,5.40540540540541
"E00021448",141,13,36,80,12,77,7,20,41,9,64,6,16,39,3,9.21985815602837,25.531914893617,56.7375886524823,8.51063829787234,54.6099290780142,4.9645390070922,14.1843971631206,29.0780141843972,6.38297872340426,45.3900709219858,4.25531914893617,11.3475177304965,27.6595744680851,2.12765957446809
"E00021449",186,9,38,105,34,93,6,17,50,20,93,3,21,55,14,4.83870967741935,20.4301075268817,56.4516129032258,18.2795698924731,50,3.2258064516129,9.13978494623656,26.8817204301075,10.752688172043,50,1.61290322580645,11.2903225806452,29.5698924731183,7.52688172043011
"E00021450",105,9,14,60,22,59,3,3,39,14,46,6,11,21,8,8.57142857142857,13.3333333333333,57.1428571428571,20.952380952381,56.1904761904762,2.85714285714286,2.85714285714286,37.1428571428571,13.3333333333333,43.8095238095238,5.71428571428571,10.4761904761905,20,7.61904761904762
"E00021451",146,10,42,82,12,87,7,26,48,6,59,3,16,34,6,6.84931506849315,28.7671232876712,56.1643835616438,8.21917808219178,59.5890410958904,4.79452054794521,17.8082191780822,32.8767123287671,4.10958904109589,40.4109589041096,2.05479452054794,10.958904109589,23.2876712328767,4.10958904109589
"E00021452",111,12,24,60,15,63,6,10,39,8,48,6,14,21,7,10.8108108108108,21.6216216216216,54.0540540540541,13.5135135135135,56.7567567567568,5.40540540540541,9.00900900900901,35.1351351351351,7.20720720720721,43.2432432432432,5.40540540540541,12.6126126126126,18.9189189189189,6.30630630630631
"E00021453",153,9,21,100,23,80,3,8,57,12,73,6,13,43,11,5.88235294117647,13.7254901960784,65.359477124183,15.0326797385621,52.2875816993464,1.96078431372549,5.22875816993464,37.2549019607843,7.84313725490196,47.7124183006536,3.92156862745098,8.49673202614379,28.1045751633987,7.18954248366013
"E00021454",143,20,35,79,9,76,11,19,41,5,67,9,16,38,4,13.986013986014,24.4755244755245,55.2447552447552,6.29370629370629,53.1468531468531,7.69230769230769,13.2867132867133,28.6713286713287,3.4965034965035,46.8531468531469,6.29370629370629,11.1888111888112,26.5734265734266,2.7972027972028
"E00021455",121,10,37,64,10,63,2,20,34,7,58,8,17,30,3,8.26446280991736,30.5785123966942,52.8925619834711,8.26446280991736,52.0661157024793,1.65289256198347,16.5289256198347,28.099173553719,5.78512396694215,47.9338842975207,6.61157024793388,14.0495867768595,24.7933884297521,2.47933884297521
"E00021458",210,24,30,120,36,125,15,13,76,21,85,9,17,44,15,11.4285714285714,14.2857142857143,57.1428571428571,17.1428571428571,59.5238095238095,7.14285714285714,6.19047619047619,36.1904761904762,10,40.4761904761905,4.28571428571429,8.09523809523809,20.952380952381,7.14285714285714
"E00021459",183,9,16,128,30,94,5,9,59,21,89,4,7,69,9,4.91803278688525,8.7431693989071,69.9453551912568,16.3934426229508,51.3661202185792,2.73224043715847,4.91803278688525,32.2404371584699,11.4754098360656,48.6338797814208,2.18579234972678,3.82513661202186,37.7049180327869,4.91803278688525
"E00021460",222,20,34,125,43,121,17,19,56,29,101,3,15,69,14,9.00900900900901,15.3153153153153,56.3063063063063,19.3693693693694,54.5045045045045,7.65765765765766,8.55855855855856,25.2252252252252,13.0630630630631,45.4954954954955,1.35135135135135,6.75675675675676,31.0810810810811,6.30630630630631
"E00021461",127,8,19,84,16,66,3,13,38,12,61,5,6,46,4,6.2992125984252,14.9606299212598,66.1417322834646,12.5984251968504,51.9685039370079,2.36220472440945,10.2362204724409,29.9212598425197,9.44881889763779,48.0314960629921,3.93700787401575,4.7244094488189,36.2204724409449,3.1496062992126
"E00021462",129,16,26,65,22,63,6,14,32,11,66,10,12,33,11,12.4031007751938,20.1550387596899,50.3875968992248,17.0542635658915,48.8372093023256,4.65116279069767,10.8527131782946,24.8062015503876,8.52713178294574,51.1627906976744,7.75193798449612,9.30232558139535,25.5813953488372,8.52713178294574
"E00021463",159,10,35,98,16,92,6,19,55,12,67,4,16,43,4,6.28930817610063,22.0125786163522,61.6352201257862,10.062893081761,57.8616352201258,3.77358490566038,11.9496855345912,34.5911949685535,7.54716981132075,42.1383647798742,2.51572327044025,10.062893081761,27.0440251572327,2.51572327044025
"E00021464",136,6,25,89,16,65,1,10,44,10,71,5,15,45,6,4.41176470588235,18.3823529411765,65.4411764705882,11.7647058823529,47.7941176470588,0.735294117647059,7.35294117647059,32.3529411764706,7.35294117647059,52.2058823529412,3.67647058823529,11.0294117647059,33.0882352941176,4.41176470588235
"E00021465",150,16,38,75,21,78,7,21,34,16,72,9,17,41,5,10.6666666666667,25.3333333333333,50,14,52,4.66666666666667,14,22.6666666666667,10.6666666666667,48,6,11.3333333333333,27.3333333333333,3.33333333333333
"E00021466",193,62,57,59,15,100,29,25,34,12,93,33,32,25,3,32.1243523316062,29.5336787564767,30.5699481865285,7.7720207253886,51.8134715025907,15.0259067357513,12.9533678756477,17.6165803108808,6.21761658031088,48.1865284974093,17.0984455958549,16.580310880829,12.9533678756477,1.55440414507772
"E00021467",119,31,48,38,2,68,10,33,23,2,51,21,15,15,0,26.0504201680672,40.3361344537815,31.9327731092437,1.68067226890756,57.1428571428571,8.40336134453782,27.7310924369748,19.327731092437,1.68067226890756,42.8571428571429,17.6470588235294,12.6050420168067,12.6050420168067,0
"E00021468",136,8,24,90,14,87,4,11,62,10,49,4,13,28,4,5.88235294117647,17.6470588235294,66.1764705882353,10.2941176470588,63.9705882352941,2.94117647058824,8.08823529411765,45.5882352941176,7.35294117647059,36.0294117647059,2.94117647058824,9.55882352941176,20.5882352941176,2.94117647058824
"E00021469",161,16,49,86,10,85,6,29,41,9,76,10,20,45,1,9.93788819875776,30.4347826086957,53.416149068323,6.2111801242236,52.7950310559006,3.72670807453416,18.0124223602484,25.4658385093168,5.59006211180124,47.2049689440994,6.2111801242236,12.4223602484472,27.9503105590062,0.62111801242236
"E00021470",102,15,19,60,8,56,7,10,36,3,46,8,9,24,5,14.7058823529412,18.6274509803922,58.8235294117647,7.84313725490196,54.9019607843137,6.86274509803922,9.80392156862745,35.2941176470588,2.94117647058824,45.0980392156863,7.84313725490196,8.82352941176471,23.5294117647059,4.90196078431373
"E00021471",131,15,40,62,14,72,9,20,32,11,59,6,20,30,3,11.4503816793893,30.5343511450382,47.3282442748092,10.6870229007634,54.9618320610687,6.87022900763359,15.2671755725191,24.4274809160305,8.3969465648855,45.0381679389313,4.58015267175572,15.2671755725191,22.9007633587786,2.29007633587786
"E00021473",105,23,29,44,9,59,13,17,24,5,46,10,12,20,4,21.9047619047619,27.6190476190476,41.9047619047619,8.57142857142857,56.1904761904762,12.3809523809524,16.1904761904762,22.8571428571429,4.76190476190476,43.8095238095238,9.52380952380952,11.4285714285714,19.047619047619,3.80952380952381
"E00021474",151,17,59,68,7,88,5,35,43,5,63,12,24,25,2,11.2582781456954,39.0728476821192,45.0331125827815,4.63576158940397,58.2781456953642,3.3112582781457,23.1788079470199,28.476821192053,3.3112582781457,41.7218543046358,7.94701986754967,15.8940397350993,16.5562913907285,1.32450331125828
"E00021475",164,33,43,70,18,107,17,31,47,12,57,16,12,23,6,20.1219512195122,26.219512195122,42.6829268292683,10.9756097560976,65.2439024390244,10.3658536585366,18.9024390243902,28.6585365853659,7.31707317073171,34.7560975609756,9.75609756097561,7.31707317073171,14.0243902439024,3.65853658536585
"E00021476",151,15,46,79,11,82,5,29,39,9,69,10,17,40,2,9.93377483443709,30.4635761589404,52.317880794702,7.28476821192053,54.3046357615894,3.3112582781457,19.205298013245,25.8278145695364,5.96026490066225,45.6953642384106,6.62251655629139,11.2582781456954,26.4900662251656,1.32450331125828
"E00021477",241,26,29,143,43,152,14,20,87,31,89,12,9,56,12,10.7883817427386,12.0331950207469,59.3360995850622,17.8423236514523,63.0705394190871,5.80912863070539,8.29875518672199,36.0995850622407,12.8630705394191,36.9294605809129,4.9792531120332,3.7344398340249,23.2365145228216,4.9792531120332
"E00021478",158,11,24,97,26,83,3,15,50,15,75,8,9,47,11,6.9620253164557,15.1898734177215,61.3924050632911,16.4556962025316,52.5316455696203,1.89873417721519,9.49367088607595,31.6455696202532,9.49367088607595,47.4683544303797,5.06329113924051,5.69620253164557,29.746835443038,6.9620253164557
"E00021479",230,40,36,109,45,122,25,20,51,26,108,15,16,58,19,17.3913043478261,15.6521739130435,47.3913043478261,19.5652173913043,53.0434782608696,10.8695652173913,8.69565217391304,22.1739130434783,11.304347826087,46.9565217391304,6.52173913043478,6.95652173913043,25.2173913043478,8.26086956521739
"E00021480",195,17,20,116,42,108,10,8,63,27,87,7,12,53,15,8.71794871794872,10.2564102564103,59.4871794871795,21.5384615384615,55.3846153846154,5.12820512820513,4.1025641025641,32.3076923076923,13.8461538461538,44.6153846153846,3.58974358974359,6.15384615384615,27.1794871794872,7.69230769230769
"E00021481",136,18,35,71,12,85,9,26,41,9,51,9,9,30,3,13.2352941176471,25.7352941176471,52.2058823529412,8.82352941176471,62.5,6.61764705882353,19.1176470588235,30.1470588235294,6.61764705882353,37.5,6.61764705882353,6.61764705882353,22.0588235294118,2.20588235294118
"E00021482",231,29,35,142,25,128,13,15,84,16,103,16,20,58,9,12.5541125541126,15.1515151515152,61.4718614718615,10.8225108225108,55.4112554112554,5.62770562770563,6.49350649350649,36.3636363636364,6.92640692640693,44.5887445887446,6.92640692640693,8.65800865800866,25.1082251082251,3.8961038961039
"E00021483",333,17,52,193,71,211,11,28,119,53,122,6,24,74,18,5.10510510510511,15.6156156156156,57.957957957958,21.3213213213213,63.3633633633634,3.3033033033033,8.40840840840841,35.7357357357357,15.9159159159159,36.6366366366366,1.8018018018018,7.20720720720721,22.2222222222222,5.40540540540541
"E00021484",204,22,27,121,34,111,12,18,58,23,93,10,9,63,11,10.7843137254902,13.2352941176471,59.3137254901961,16.6666666666667,54.4117647058823,5.88235294117647,8.82352941176471,28.4313725490196,11.2745098039216,45.5882352941176,4.90196078431373,4.41176470588235,30.8823529411765,5.3921568627451
"E00021485",133,20,37,70,6,74,6,22,41,5,59,14,15,29,1,15.0375939849624,27.8195488721804,52.6315789473684,4.51127819548872,55.6390977443609,4.51127819548872,16.5413533834586,30.8270676691729,3.7593984962406,44.3609022556391,10.5263157894737,11.2781954887218,21.8045112781955,0.75187969924812
"E00021486",143,14,39,76,14,79,4,23,41,11,64,10,16,35,3,9.79020979020979,27.2727272727273,53.1468531468531,9.79020979020979,55.2447552447552,2.7972027972028,16.0839160839161,28.6713286713287,7.69230769230769,44.7552447552448,6.99300699300699,11.1888111888112,24.4755244755245,2.0979020979021
"E00021487",73,8,23,33,9,41,4,11,18,8,32,4,12,15,1,10.958904109589,31.5068493150685,45.2054794520548,12.3287671232877,56.1643835616438,5.47945205479452,15.0684931506849,24.6575342465753,10.958904109589,43.8356164383562,5.47945205479452,16.4383561643836,20.5479452054795,1.36986301369863
"E00021488",173,22,42,87,22,101,11,22,51,17,72,11,20,36,5,12.7167630057803,24.2774566473988,50.2890173410405,12.7167630057803,58.3815028901734,6.35838150289017,12.7167630057803,29.4797687861272,9.82658959537572,41.6184971098266,6.35838150289017,11.5606936416185,20.8092485549133,2.89017341040462
"E00021489",111,10,28,66,7,58,3,19,30,6,53,7,9,36,1,9.00900900900901,25.2252252252252,59.4594594594595,6.30630630630631,52.2522522522522,2.7027027027027,17.1171171171171,27.027027027027,5.40540540540541,47.7477477477478,6.30630630630631,8.10810810810811,32.4324324324324,0.900900900900901
"E00021490",82,9,28,38,7,44,1,17,21,5,38,8,11,17,2,10.9756097560976,34.1463414634146,46.3414634146341,8.53658536585366,53.6585365853659,1.21951219512195,20.7317073170732,25.609756097561,6.09756097560976,46.3414634146341,9.75609756097561,13.4146341463415,20.7317073170732,2.4390243902439
"E00021491",92,22,33,32,5,62,15,22,21,4,30,7,11,11,1,23.9130434782609,35.8695652173913,34.7826086956522,5.43478260869565,67.3913043478261,16.304347826087,23.9130434782609,22.8260869565217,4.34782608695652,32.6086956521739,7.60869565217391,11.9565217391304,11.9565217391304,1.08695652173913
"E00021492",120,13,44,60,3,81,6,30,42,3,39,7,14,18,0,10.8333333333333,36.6666666666667,50,2.5,67.5,5,25,35,2.5,32.5,5.83333333333333,11.6666666666667,15,0
"E00021493",137,19,39,75,4,86,9,28,45,4,51,10,11,30,0,13.8686131386861,28.4671532846715,54.7445255474453,2.91970802919708,62.7737226277372,6.56934306569343,20.4379562043796,32.8467153284672,2.91970802919708,37.2262773722628,7.2992700729927,8.02919708029197,21.8978102189781,0
"E00021494",206,36,46,103,21,118,18,25,57,18,88,18,21,46,3,17.4757281553398,22.3300970873786,50,10.1941747572816,57.2815533980583,8.7378640776699,12.1359223300971,27.6699029126214,8.7378640776699,42.7184466019417,8.7378640776699,10.1941747572816,22.3300970873786,1.45631067961165
"E00021495",213,21,57,115,20,126,12,41,62,11,87,9,16,53,9,9.85915492957746,26.7605633802817,53.9906103286385,9.38967136150235,59.1549295774648,5.63380281690141,19.2488262910798,29.1079812206573,5.16431924882629,40.8450704225352,4.22535211267606,7.51173708920188,24.8826291079812,4.22535211267606
"E00021496",75,12,24,36,3,43,5,17,19,2,32,7,7,17,1,16,32,48,4,57.3333333333333,6.66666666666667,22.6666666666667,25.3333333333333,2.66666666666667,42.6666666666667,9.33333333333333,9.33333333333333,22.6666666666667,1.33333333333333
"E00021497",135,17,46,63,9,90,11,32,38,9,45,6,14,25,0,12.5925925925926,34.0740740740741,46.6666666666667,6.66666666666667,66.6666666666667,8.14814814814815,23.7037037037037,28.1481481481481,6.66666666666667,33.3333333333333,4.44444444444444,10.3703703703704,18.5185185185185,0
"E00021498",117,20,41,47,9,69,8,26,29,6,48,12,15,18,3,17.0940170940171,35.042735042735,40.1709401709402,7.69230769230769,58.974358974359,6.83760683760684,22.2222222222222,24.7863247863248,5.12820512820513,41.025641025641,10.2564102564103,12.8205128205128,15.3846153846154,2.56410256410256
"E00021499",188,13,27,97,51,108,6,14,56,32,80,7,13,41,19,6.91489361702128,14.3617021276596,51.5957446808511,27.1276595744681,57.4468085106383,3.19148936170213,7.4468085106383,29.7872340425532,17.0212765957447,42.5531914893617,3.72340425531915,6.91489361702128,21.8085106382979,10.1063829787234
"E00021500",188,13,25,114,36,100,4,13,56,27,88,9,12,58,9,6.91489361702128,13.2978723404255,60.6382978723404,19.1489361702128,53.1914893617021,2.12765957446809,6.91489361702128,29.7872340425532,14.3617021276596,46.8085106382979,4.78723404255319,6.38297872340426,30.8510638297872,4.78723404255319
"E00021501",115,5,23,64,23,67,3,16,32,16,48,2,7,32,7,4.34782608695652,20,55.6521739130435,20,58.2608695652174,2.60869565217391,13.9130434782609,27.8260869565217,13.9130434782609,41.7391304347826,1.73913043478261,6.08695652173913,27.8260869565217,6.08695652173913
"E00021502",100,11,30,54,5,62,5,18,36,3,38,6,12,18,2,11,30,54,5,62,5,18,36,3,38,6,12,18,2
"E00021503",124,15,49,53,7,75,5,33,33,4,49,10,16,20,3,12.0967741935484,39.5161290322581,42.741935483871,5.64516129032258,60.4838709677419,4.03225806451613,26.6129032258064,26.6129032258064,3.2258064516129,39.5161290322581,8.06451612903226,12.9032258064516,16.1290322580645,2.41935483870968
"E00021504",150,12,39,84,15,90,7,27,45,11,60,5,12,39,4,8,26,56,10,60,4.66666666666667,18,30,7.33333333333333,40,3.33333333333333,8,26,2.66666666666667
"E00021505",90,8,19,59,4,57,2,11,40,4,33,6,8,19,0,8.88888888888889,21.1111111111111,65.5555555555556,4.44444444444444,63.3333333333333,2.22222222222222,12.2222222222222,44.4444444444444,4.44444444444444,36.6666666666667,6.66666666666667,8.88888888888889,21.1111111111111,0
"E00021506",140,13,32,79,16,84,3,16,54,11,56,10,16,25,5,9.28571428571429,22.8571428571429,56.4285714285714,11.4285714285714,60,2.14285714285714,11.4285714285714,38.5714285714286,7.85714285714286,40,7.14285714285714,11.4285714285714,17.8571428571429,3.57142857142857
"E00021507",177,14,18,113,32,96,5,10,57,24,81,9,8,56,8,7.90960451977401,10.1694915254237,63.8418079096045,18.0790960451977,54.2372881355932,2.82485875706215,5.64971751412429,32.2033898305085,13.5593220338983,45.7627118644068,5.08474576271187,4.51977401129944,31.638418079096,4.51977401129944
"E00021508",168,16,42,84,26,88,9,25,40,14,80,7,17,44,12,9.52380952380952,25,50,15.4761904761905,52.3809523809524,5.35714285714286,14.8809523809524,23.8095238095238,8.33333333333333,47.6190476190476,4.16666666666667,10.1190476190476,26.1904761904762,7.14285714285714
"E00021509",197,24,62,101,10,106,11,32,55,8,91,13,30,46,2,12.1827411167513,31.4720812182741,51.2690355329949,5.0761421319797,53.8071065989848,5.58375634517767,16.243654822335,27.9187817258883,4.06091370558376,46.1928934010152,6.5989847715736,15.2284263959391,23.3502538071066,1.01522842639594
"E00021510",154,3,6,58,87,98,2,2,31,63,56,1,4,27,24,1.94805194805195,3.8961038961039,37.6623376623377,56.4935064935065,63.6363636363636,1.2987012987013,1.2987012987013,20.1298701298701,40.9090909090909,36.3636363636364,0.649350649350649,2.5974025974026,17.5324675324675,15.5844155844156
"E00021511",142,5,5,39,93,86,0,5,19,62,56,5,0,20,31,3.52112676056338,3.52112676056338,27.4647887323944,65.4929577464789,60.5633802816901,0,3.52112676056338,13.3802816901408,43.6619718309859,39.4366197183099,3.52112676056338,0,14.0845070422535,21.830985915493
"E00021516",151,5,22,106,18,88,3,11,61,13,63,2,11,45,5,3.3112582781457,14.5695364238411,70.1986754966888,11.9205298013245,58.2781456953642,1.98675496688742,7.28476821192053,40.3973509933775,8.60927152317881,41.7218543046358,1.32450331125828,7.28476821192053,29.8013245033113,3.3112582781457
"E00021517",177,6,30,113,28,97,5,10,64,18,80,1,20,49,10,3.38983050847458,16.9491525423729,63.8418079096045,15.819209039548,54.8022598870056,2.82485875706215,5.64971751412429,36.1581920903955,10.1694915254237,45.1977401129944,0.564971751412429,11.2994350282486,27.683615819209,5.64971751412429
"E00021518",186,10,30,107,39,101,2,18,52,29,85,8,12,55,10,5.37634408602151,16.1290322580645,57.5268817204301,20.9677419354839,54.3010752688172,1.0752688172043,9.67741935483871,27.9569892473118,15.5913978494624,45.6989247311828,4.3010752688172,6.45161290322581,29.5698924731183,5.37634408602151
"E00021519",304,29,17,179,79,162,8,4,101,49,142,21,13,78,30,9.53947368421053,5.59210526315789,58.8815789473684,25.9868421052632,53.2894736842105,2.63157894736842,1.31578947368421,33.2236842105263,16.1184210526316,46.7105263157895,6.90789473684211,4.27631578947368,25.6578947368421,9.86842105263158
"E00021520",146,11,14,85,36,94,5,5,61,23,52,6,9,24,13,7.53424657534247,9.58904109589041,58.2191780821918,24.6575342465753,64.3835616438356,3.42465753424658,3.42465753424658,41.7808219178082,15.7534246575342,35.6164383561644,4.10958904109589,6.16438356164384,16.4383561643836,8.9041095890411
"E00021521",126,10,25,70,21,67,2,9,40,16,59,8,16,30,5,7.93650793650794,19.8412698412698,55.5555555555556,16.6666666666667,53.1746031746032,1.58730158730159,7.14285714285714,31.7460317460317,12.6984126984127,46.8253968253968,6.34920634920635,12.6984126984127,23.8095238095238,3.96825396825397
"E00021522",159,17,29,94,19,99,8,17,56,18,60,9,12,38,1,10.6918238993711,18.2389937106918,59.1194968553459,11.9496855345912,62.2641509433962,5.0314465408805,10.6918238993711,35.2201257861635,11.3207547169811,37.7358490566038,5.66037735849057,7.54716981132075,23.8993710691824,0.628930817610063
"E00021524",257,23,47,147,40,138,10,23,82,23,119,13,24,65,17,8.94941634241245,18.2879377431907,57.1984435797665,15.5642023346303,53.6964980544747,3.89105058365759,8.94941634241245,31.9066147859922,8.94941634241245,46.3035019455253,5.05836575875486,9.33852140077821,25.2918287937743,6.6147859922179
"E00021525",184,3,22,126,33,113,1,10,80,22,71,2,12,46,11,1.6304347826087,11.9565217391304,68.4782608695652,17.9347826086957,61.4130434782609,0.543478260869565,5.43478260869565,43.4782608695652,11.9565217391304,38.5869565217391,1.08695652173913,6.52173913043478,25,5.97826086956522
"E00021526",250,11,7,159,73,135,4,2,77,52,115,7,5,82,21,4.4,2.8,63.6,29.2,54,1.6,0.8,30.8,20.8,46,2.8,2,32.8,8.4
"E00021527",203,7,16,139,41,127,4,8,84,31,76,3,8,55,10,3.44827586206897,7.88177339901478,68.4729064039409,20.1970443349754,62.5615763546798,1.97044334975369,3.94088669950739,41.3793103448276,15.2709359605911,37.4384236453202,1.47783251231527,3.94088669950739,27.0935960591133,4.92610837438424
"E00021528",115,10,23,65,17,58,3,10,32,13,57,7,13,33,4,8.69565217391304,20,56.5217391304348,14.7826086956522,50.4347826086956,2.60869565217391,8.69565217391304,27.8260869565217,11.304347826087,49.5652173913044,6.08695652173913,11.304347826087,28.695652173913,3.47826086956522
"E00021529",73,5,9,39,20,39,1,3,21,14,34,4,6,18,6,6.84931506849315,12.3287671232877,53.4246575342466,27.3972602739726,53.4246575342466,1.36986301369863,4.10958904109589,28.7671232876712,19.1780821917808,46.5753424657534,5.47945205479452,8.21917808219178,24.6575342465753,8.21917808219178
"E00021531",208,14,44,129,21,120,7,23,75,15,88,7,21,54,6,6.73076923076923,21.1538461538462,62.0192307692308,10.0961538461538,57.6923076923077,3.36538461538462,11.0576923076923,36.0576923076923,7.21153846153846,42.3076923076923,3.36538461538462,10.0961538461538,25.9615384615385,2.88461538461538
"E00021532",220,8,11,140,61,130,6,5,76,43,90,2,6,64,18,3.63636363636364,5,63.6363636363636,27.7272727272727,59.0909090909091,2.72727272727273,2.27272727272727,34.5454545454545,19.5454545454545,40.9090909090909,0.909090909090909,2.72727272727273,29.0909090909091,8.18181818181818
"E00021533",198,9,10,130,49,114,4,3,77,30,84,5,7,53,19,4.54545454545455,5.05050505050505,65.6565656565657,24.7474747474747,57.5757575757576,2.02020202020202,1.51515151515152,38.8888888888889,15.1515151515152,42.4242424242424,2.52525252525253,3.53535353535354,26.7676767676768,9.5959595959596
"E00021534",180,7,10,119,44,103,5,5,61,32,77,2,5,58,12,3.88888888888889,5.55555555555556,66.1111111111111,24.4444444444444,57.2222222222222,2.77777777777778,2.77777777777778,33.8888888888889,17.7777777777778,42.7777777777778,1.11111111111111,2.77777777777778,32.2222222222222,6.66666666666667
"E00021535",168,14,24,99,31,87,6,11,47,23,81,8,13,52,8,8.33333333333333,14.2857142857143,58.9285714285714,18.452380952381,51.7857142857143,3.57142857142857,6.54761904761905,27.9761904761905,13.6904761904762,48.2142857142857,4.76190476190476,7.73809523809524,30.952380952381,4.76190476190476
"E00021536",206,6,17,132,51,107,2,10,63,32,99,4,7,69,19,2.9126213592233,8.25242718446602,64.0776699029126,24.7572815533981,51.9417475728155,0.970873786407767,4.85436893203883,30.5825242718447,15.5339805825243,48.0582524271845,1.94174757281553,3.39805825242718,33.495145631068,9.22330097087379
"E00021537",254,12,7,136,99,148,4,2,76,66,106,8,5,60,33,4.7244094488189,2.75590551181102,53.5433070866142,38.9763779527559,58.2677165354331,1.5748031496063,0.78740157480315,29.9212598425197,25.9842519685039,41.7322834645669,3.1496062992126,1.96850393700787,23.6220472440945,12.992125984252
"E00021538",505,21,36,299,149,285,5,12,167,101,220,16,24,132,48,4.15841584158416,7.12871287128713,59.2079207920792,29.5049504950495,56.4356435643564,0.99009900990099,2.37623762376238,33.0693069306931,20,43.5643564356436,3.16831683168317,4.75247524752475,26.1386138613861,9.5049504950495
"E00021539",206,10,13,124,59,125,3,7,76,39,81,7,6,48,20,4.85436893203883,6.31067961165049,60.1941747572816,28.6407766990291,60.6796116504854,1.45631067961165,3.39805825242718,36.8932038834951,18.9320388349515,39.3203883495146,3.39805825242718,2.9126213592233,23.3009708737864,9.70873786407767
"E00021541",171,6,4,99,62,97,2,1,49,45,74,4,3,50,17,3.50877192982456,2.33918128654971,57.8947368421053,36.2573099415205,56.7251461988304,1.16959064327485,0.584795321637427,28.6549707602339,26.3157894736842,43.2748538011696,2.33918128654971,1.75438596491228,29.2397660818713,9.94152046783626
"E00021542",145,2,16,94,33,88,1,7,54,26,57,1,9,40,7,1.37931034482759,11.0344827586207,64.8275862068965,22.7586206896552,60.6896551724138,0.689655172413793,4.82758620689655,37.2413793103448,17.9310344827586,39.3103448275862,0.689655172413793,6.20689655172414,27.5862068965517,4.82758620689655
"E00021543",211,8,10,109,84,129,2,4,64,59,82,6,6,45,25,3.7914691943128,4.739336492891,51.6587677725119,39.8104265402844,61.1374407582938,0.947867298578199,1.8957345971564,30.3317535545024,27.9620853080569,38.8625592417062,2.8436018957346,2.8436018957346,21.3270142180095,11.8483412322275
"E00021544",143,4,3,69,67,81,0,1,33,47,62,4,2,36,20,2.7972027972028,2.0979020979021,48.2517482517483,46.8531468531469,56.6433566433566,0,0.699300699300699,23.0769230769231,32.8671328671329,43.3566433566434,2.7972027972028,1.3986013986014,25.1748251748252,13.986013986014
"E00021546",147,1,4,69,73,90,1,1,39,49,57,0,3,30,24,0.680272108843537,2.72108843537415,46.9387755102041,49.6598639455782,61.2244897959184,0.680272108843537,0.680272108843537,26.530612244898,33.3333333333333,38.7755102040816,0,2.04081632653061,20.4081632653061,16.3265306122449
"E00021547",121,15,18,71,17,71,8,10,45,8,50,7,8,26,9,12.396694214876,14.8760330578512,58.6776859504132,14.0495867768595,58.6776859504132,6.61157024793388,8.26446280991736,37.1900826446281,6.61157024793388,41.3223140495868,5.78512396694215,6.61157024793388,21.4876033057851,7.43801652892562
"E00021549",156,15,32,89,20,89,8,14,52,15,67,7,18,37,5,9.61538461538462,20.5128205128205,57.0512820512821,12.8205128205128,57.0512820512821,5.12820512820513,8.97435897435897,33.3333333333333,9.61538461538462,42.9487179487179,4.48717948717949,11.5384615384615,23.7179487179487,3.2051282051282
"E00021550",148,22,30,80,16,68,3,13,46,6,80,19,17,34,10,14.8648648648649,20.2702702702703,54.0540540540541,10.8108108108108,45.945945945946,2.02702702702703,8.78378378378378,31.0810810810811,4.05405405405405,54.0540540540541,12.8378378378378,11.4864864864865,22.972972972973,6.75675675675676
"E00021552",98,20,17,45,16,60,10,10,25,15,38,10,7,20,1,20.4081632653061,17.3469387755102,45.9183673469388,16.3265306122449,61.2244897959184,10.2040816326531,10.2040816326531,25.5102040816327,15.3061224489796,38.7755102040816,10.2040816326531,7.14285714285714,20.4081632653061,1.02040816326531
"E00021553",111,12,31,53,15,66,6,18,32,10,45,6,13,21,5,10.8108108108108,27.9279279279279,47.7477477477478,13.5135135135135,59.4594594594595,5.40540540540541,16.2162162162162,28.8288288288288,9.00900900900901,40.5405405405405,5.40540540540541,11.7117117117117,18.9189189189189,4.5045045045045
"E00021554",162,5,19,113,25,81,3,5,59,14,81,2,14,54,11,3.08641975308642,11.7283950617284,69.7530864197531,15.4320987654321,50,1.85185185185185,3.08641975308642,36.4197530864198,8.64197530864197,50,1.23456790123457,8.64197530864197,33.3333333333333,6.79012345679012
"E00021555",170,8,35,89,38,105,4,19,53,29,65,4,16,36,9,4.70588235294118,20.5882352941176,52.3529411764706,22.3529411764706,61.7647058823529,2.35294117647059,11.1764705882353,31.1764705882353,17.0588235294118,38.2352941176471,2.35294117647059,9.41176470588235,21.1764705882353,5.29411764705882
"E00021556",213,6,9,138,60,132,2,4,85,41,81,4,5,53,19,2.8169014084507,4.22535211267606,64.7887323943662,28.169014084507,61.9718309859155,0.938967136150235,1.87793427230047,39.906103286385,19.2488262910798,38.0281690140845,1.87793427230047,2.34741784037559,24.8826291079812,8.92018779342723
"E00021557",243,5,20,155,63,130,2,9,81,38,113,3,11,74,25,2.05761316872428,8.23045267489712,63.7860082304527,25.9259259259259,53.4979423868313,0.823045267489712,3.7037037037037,33.3333333333333,15.6378600823045,46.5020576131687,1.23456790123457,4.52674897119342,30.4526748971193,10.2880658436214
"E00021559",166,11,22,98,35,94,7,11,54,22,72,4,11,44,13,6.62650602409639,13.2530120481928,59.0361445783133,21.0843373493976,56.6265060240964,4.21686746987952,6.62650602409639,32.5301204819277,13.2530120481928,43.3734939759036,2.40963855421687,6.62650602409639,26.5060240963855,7.83132530120482
"E00021560",176,15,34,101,26,101,9,19,54,19,75,6,15,47,7,8.52272727272727,19.3181818181818,57.3863636363636,14.7727272727273,57.3863636363636,5.11363636363636,10.7954545454545,30.6818181818182,10.7954545454545,42.6136363636364,3.40909090909091,8.52272727272727,26.7045454545455,3.97727272727273
"E00021561",165,24,22,100,19,84,6,13,52,13,81,18,9,48,6,14.5454545454545,13.3333333333333,60.6060606060606,11.5151515151515,50.9090909090909,3.63636363636364,7.87878787878788,31.5151515151515,7.87878787878788,49.0909090909091,10.9090909090909,5.45454545454545,29.0909090909091,3.63636363636364
"E00021562",185,17,30,112,26,103,6,14,64,19,82,11,16,48,7,9.18918918918919,16.2162162162162,60.5405405405405,14.0540540540541,55.6756756756757,3.24324324324324,7.56756756756757,34.5945945945946,10.2702702702703,44.3243243243243,5.94594594594595,8.64864864864865,25.9459459459459,3.78378378378378
"E00021563",153,16,24,86,27,95,5,16,58,16,58,11,8,28,11,10.4575163398693,15.6862745098039,56.2091503267974,17.6470588235294,62.0915032679739,3.26797385620915,10.4575163398693,37.9084967320261,10.4575163398693,37.9084967320261,7.18954248366013,5.22875816993464,18.3006535947712,7.18954248366013
"E00021564",118,14,26,69,9,70,9,15,40,6,48,5,11,29,3,11.864406779661,22.0338983050847,58.4745762711864,7.6271186440678,59.3220338983051,7.6271186440678,12.7118644067797,33.8983050847458,5.08474576271187,40.6779661016949,4.23728813559322,9.32203389830508,24.5762711864407,2.54237288135593
"E00021565",78,8,16,48,6,47,4,10,29,4,31,4,6,19,2,10.2564102564103,20.5128205128205,61.5384615384615,7.69230769230769,60.2564102564103,5.12820512820513,12.8205128205128,37.1794871794872,5.12820512820513,39.7435897435897,5.12820512820513,7.69230769230769,24.3589743589744,2.56410256410256
"E00021566",192,26,32,105,29,102,16,13,54,19,90,10,19,51,10,13.5416666666667,16.6666666666667,54.6875,15.1041666666667,53.125,8.33333333333333,6.77083333333333,28.125,9.89583333333333,46.875,5.20833333333333,9.89583333333333,26.5625,5.20833333333333
"E00021567",193,26,31,97,39,96,12,13,49,22,97,14,18,48,17,13.4715025906736,16.0621761658031,50.259067357513,20.2072538860104,49.740932642487,6.21761658031088,6.73575129533679,25.3886010362694,11.3989637305699,50.259067357513,7.25388601036269,9.32642487046632,24.8704663212435,8.80829015544041
"E00021569",173,20,30,89,34,93,7,14,45,27,80,13,16,44,7,11.5606936416185,17.3410404624277,51.4450867052023,19.6531791907514,53.757225433526,4.04624277456647,8.09248554913295,26.0115606936416,15.606936416185,46.242774566474,7.51445086705202,9.2485549132948,25.4335260115607,4.04624277456647
"E00021572",172,28,45,83,16,96,14,29,44,9,76,14,16,39,7,16.2790697674419,26.1627906976744,48.2558139534884,9.30232558139535,55.8139534883721,8.13953488372093,16.8604651162791,25.5813953488372,5.23255813953488,44.1860465116279,8.13953488372093,9.30232558139535,22.6744186046512,4.06976744186047
"E00021574",118,15,30,64,9,59,10,15,28,6,59,5,15,36,3,12.7118644067797,25.4237288135593,54.2372881355932,7.6271186440678,50,8.47457627118644,12.7118644067797,23.728813559322,5.08474576271187,50,4.23728813559322,12.7118644067797,30.5084745762712,2.54237288135593
"E00021577",108,22,20,53,13,53,8,11,24,10,55,14,9,29,3,20.3703703703704,18.5185185185185,49.0740740740741,12.037037037037,49.0740740740741,7.40740740740741,10.1851851851852,22.2222222222222,9.25925925925926,50.9259259259259,12.962962962963,8.33333333333333,26.8518518518519,2.77777777777778
"E00021579",128,16,46,51,15,78,9,27,33,9,50,7,19,18,6,12.5,35.9375,39.84375,11.71875,60.9375,7.03125,21.09375,25.78125,7.03125,39.0625,5.46875,14.84375,14.0625,4.6875
"E00021580",118,14,51,48,5,74,7,32,31,4,44,7,19,17,1,11.864406779661,43.2203389830509,40.6779661016949,4.23728813559322,62.7118644067797,5.93220338983051,27.1186440677966,26.271186440678,3.38983050847458,37.2881355932203,5.93220338983051,16.1016949152542,14.4067796610169,0.847457627118644
"E00021582",122,18,32,64,8,74,9,19,42,4,48,9,13,22,4,14.7540983606557,26.2295081967213,52.4590163934426,6.55737704918033,60.655737704918,7.37704918032787,15.5737704918033,34.4262295081967,3.27868852459016,39.344262295082,7.37704918032787,10.655737704918,18.0327868852459,3.27868852459016
"E00021583",137,22,39,64,12,95,13,32,38,12,42,9,7,26,0,16.0583941605839,28.4671532846715,46.7153284671533,8.75912408759124,69.3430656934307,9.48905109489051,23.3576642335766,27.7372262773723,8.75912408759124,30.6569343065693,6.56934306569343,5.10948905109489,18.978102189781,0
"E00021584",124,11,20,72,21,62,6,7,34,15,62,5,13,38,6,8.87096774193548,16.1290322580645,58.0645161290323,16.9354838709677,50,4.83870967741935,5.64516129032258,27.4193548387097,12.0967741935484,50,4.03225806451613,10.4838709677419,30.6451612903226,4.83870967741935
"E00021585",180,30,48,92,10,110,11,33,60,6,70,19,15,32,4,16.6666666666667,26.6666666666667,51.1111111111111,5.55555555555556,61.1111111111111,6.11111111111111,18.3333333333333,33.3333333333333,3.33333333333333,38.8888888888889,10.5555555555556,8.33333333333333,17.7777777777778,2.22222222222222
"E00021586",163,24,56,74,9,95,12,35,39,9,68,12,21,35,0,14.7239263803681,34.3558282208589,45.398773006135,5.52147239263804,58.2822085889571,7.36196319018405,21.4723926380368,23.9263803680982,5.52147239263804,41.7177914110429,7.36196319018405,12.8834355828221,21.4723926380368,0
"E00021587",139,12,43,79,5,89,10,29,47,3,50,2,14,32,2,8.63309352517986,30.9352517985612,56.8345323741007,3.59712230215827,64.0287769784173,7.19424460431655,20.863309352518,33.8129496402878,2.15827338129496,35.9712230215827,1.43884892086331,10.0719424460432,23.021582733813,1.43884892086331
"E00021588",106,15,36,46,9,65,9,22,28,6,41,6,14,18,3,14.1509433962264,33.9622641509434,43.3962264150943,8.49056603773585,61.3207547169811,8.49056603773585,20.7547169811321,26.4150943396226,5.66037735849057,38.6792452830189,5.66037735849057,13.2075471698113,16.9811320754717,2.83018867924528
"E00021590",115,19,30,56,10,71,10,15,38,8,44,9,15,18,2,16.5217391304348,26.0869565217391,48.695652173913,8.69565217391304,61.7391304347826,8.69565217391304,13.0434782608696,33.0434782608696,6.95652173913043,38.2608695652174,7.82608695652174,13.0434782608696,15.6521739130435,1.73913043478261
"E00021591",94,15,39,37,3,61,8,26,26,1,33,7,13,11,2,15.9574468085106,41.4893617021277,39.3617021276596,3.19148936170213,64.8936170212766,8.51063829787234,27.6595744680851,27.6595744680851,1.06382978723404,35.1063829787234,7.4468085106383,13.8297872340426,11.7021276595745,2.12765957446809
"E00021592",131,9,30,69,23,68,4,9,38,17,63,5,21,31,6,6.87022900763359,22.9007633587786,52.6717557251908,17.5572519083969,51.9083969465649,3.05343511450382,6.87022900763359,29.0076335877863,12.9770992366412,48.0916030534351,3.81679389312977,16.030534351145,23.6641221374046,4.58015267175572
"E00021593",73,5,18,43,7,47,0,13,27,7,26,5,5,16,0,6.84931506849315,24.6575342465753,58.9041095890411,9.58904109589041,64.3835616438356,0,17.8082191780822,36.986301369863,9.58904109589041,35.6164383561644,6.84931506849315,6.84931506849315,21.9178082191781,0
"E00021594",140,15,34,76,15,81,9,21,38,13,59,6,13,38,2,10.7142857142857,24.2857142857143,54.2857142857143,10.7142857142857,57.8571428571429,6.42857142857143,15,27.1428571428571,9.28571428571429,42.1428571428571,4.28571428571429,9.28571428571429,27.1428571428571,1.42857142857143
"E00021595",154,19,27,86,22,91,11,14,50,16,63,8,13,36,6,12.3376623376623,17.5324675324675,55.8441558441558,14.2857142857143,59.0909090909091,7.14285714285714,9.09090909090909,32.4675324675325,10.3896103896104,40.9090909090909,5.19480519480519,8.44155844155844,23.3766233766234,3.8961038961039
"E00021596",204,15,27,117,45,125,3,16,81,25,79,12,11,36,20,7.35294117647059,13.2352941176471,57.3529411764706,22.0588235294118,61.2745098039216,1.47058823529412,7.84313725490196,39.7058823529412,12.2549019607843,38.7254901960784,5.88235294117647,5.3921568627451,17.6470588235294,9.80392156862745
"E00021597",169,16,43,96,14,103,10,27,56,10,66,6,16,40,4,9.46745562130178,25.4437869822485,56.8047337278106,8.28402366863905,60.9467455621302,5.91715976331361,15.9763313609467,33.1360946745562,5.91715976331361,39.0532544378698,3.55029585798817,9.46745562130178,23.6686390532544,2.36686390532544
"E00021598",190,14,9,114,53,123,11,3,70,39,67,3,6,44,14,7.36842105263158,4.73684210526316,60,27.8947368421053,64.7368421052632,5.78947368421053,1.57894736842105,36.8421052631579,20.5263157894737,35.2631578947368,1.57894736842105,3.15789473684211,23.1578947368421,7.36842105263158
"E00021599",249,9,18,148,74,148,5,7,86,50,101,4,11,62,24,3.6144578313253,7.2289156626506,59.4377510040161,29.718875502008,59.4377510040161,2.00803212851406,2.81124497991968,34.5381526104418,20.0803212851406,40.5622489959839,1.60642570281124,4.41767068273092,24.8995983935743,9.63855421686747
"E00021600",216,10,15,126,65,122,4,3,71,44,94,6,12,55,21,4.62962962962963,6.94444444444444,58.3333333333333,30.0925925925926,56.4814814814815,1.85185185185185,1.38888888888889,32.8703703703704,20.3703703703704,43.5185185185185,2.77777777777778,5.55555555555556,25.462962962963,9.72222222222222
"E00021601",160,4,18,84,54,94,0,4,48,42,66,4,14,36,12,2.5,11.25,52.5,33.75,58.75,0,2.5,30,26.25,41.25,2.5,8.75,22.5,7.5
"E00021602",235,17,27,113,78,148,13,18,73,44,87,4,9,40,34,7.23404255319149,11.4893617021277,48.0851063829787,33.1914893617021,62.9787234042553,5.53191489361702,7.65957446808511,31.063829787234,18.7234042553191,37.0212765957447,1.70212765957447,3.82978723404255,17.0212765957447,14.468085106383
"E00021603",147,3,11,71,62,89,0,4,42,43,58,3,7,29,19,2.04081632653061,7.48299319727891,48.2993197278912,42.1768707482993,60.5442176870748,0,2.72108843537415,28.5714285714286,29.2517006802721,39.4557823129252,2.04081632653061,4.76190476190476,19.7278911564626,12.9251700680272
"E00021604",184,14,22,121,27,102,8,13,59,22,82,6,9,62,5,7.60869565217391,11.9565217391304,65.7608695652174,14.6739130434783,55.4347826086957,4.34782608695652,7.06521739130435,32.0652173913043,11.9565217391304,44.5652173913043,3.26086956521739,4.89130434782609,33.695652173913,2.71739130434783
"E00021605",210,6,15,132,57,116,1,5,70,40,94,5,10,62,17,2.85714285714286,7.14285714285714,62.8571428571429,27.1428571428571,55.2380952380952,0.476190476190476,2.38095238095238,33.3333333333333,19.047619047619,44.7619047619048,2.38095238095238,4.76190476190476,29.5238095238095,8.09523809523809
"E00021606",198,9,9,94,86,129,4,5,61,59,69,5,4,33,27,4.54545454545455,4.54545454545455,47.4747474747475,43.4343434343434,65.1515151515152,2.02020202020202,2.52525252525253,30.8080808080808,29.7979797979798,34.8484848484849,2.52525252525253,2.02020202020202,16.6666666666667,13.6363636363636
"E00021607",83,12,20,39,12,51,6,15,22,8,32,6,5,17,4,14.4578313253012,24.0963855421687,46.9879518072289,14.4578313253012,61.4457831325301,7.2289156626506,18.0722891566265,26.5060240963855,9.63855421686747,38.5542168674699,7.2289156626506,6.02409638554217,20.4819277108434,4.81927710843374
"E00021608",162,5,15,104,38,84,1,6,48,29,78,4,9,56,9,3.08641975308642,9.25925925925926,64.1975308641975,23.4567901234568,51.8518518518518,0.617283950617284,3.7037037037037,29.6296296296296,17.9012345679012,48.1481481481481,2.46913580246914,5.55555555555556,34.5679012345679,5.55555555555556
"E00021610",179,5,17,95,62,115,1,12,60,42,64,4,5,35,20,2.79329608938547,9.49720670391061,53.072625698324,34.6368715083799,64.2458100558659,0.558659217877095,6.70391061452514,33.5195530726257,23.463687150838,35.7541899441341,2.23463687150838,2.79329608938547,19.5530726256983,11.1731843575419
"E00021611",223,14,22,124,63,142,8,14,72,48,81,6,8,52,15,6.2780269058296,9.86547085201794,55.6053811659193,28.2511210762332,63.677130044843,3.58744394618834,6.2780269058296,32.2869955156951,21.52466367713,36.322869955157,2.69058295964126,3.58744394618834,23.3183856502242,6.72645739910314
"E00021612",167,3,10,82,72,99,3,3,41,52,68,0,7,41,20,1.79640718562874,5.98802395209581,49.1017964071856,43.1137724550898,59.2814371257485,1.79640718562874,1.79640718562874,24.5508982035928,31.1377245508982,40.7185628742515,0,4.19161676646707,24.5508982035928,11.9760479041916
"E00021613",165,5,5,94,61,95,1,3,51,40,70,4,2,43,21,3.03030303030303,3.03030303030303,56.969696969697,36.969696969697,57.5757575757576,0.606060606060606,1.81818181818182,30.9090909090909,24.2424242424242,42.4242424242424,2.42424242424242,1.21212121212121,26.0606060606061,12.7272727272727
"E00021614",214,8,13,115,78,132,3,7,68,54,82,5,6,47,24,3.73831775700935,6.07476635514019,53.7383177570093,36.4485981308411,61.6822429906542,1.4018691588785,3.27102803738318,31.7757009345794,25.2336448598131,38.3177570093458,2.33644859813084,2.80373831775701,21.9626168224299,11.214953271028
"E00021615",174,1,6,113,54,104,1,2,60,41,70,0,4,53,13,0.574712643678161,3.44827586206897,64.9425287356322,31.0344827586207,59.7701149425287,0.574712643678161,1.14942528735632,34.4827586206897,23.5632183908046,40.2298850574713,0,2.29885057471264,30.4597701149425,7.47126436781609
"E00021616",148,17,42,70,19,87,10,29,34,14,61,7,13,36,5,11.4864864864865,28.3783783783784,47.2972972972973,12.8378378378378,58.7837837837838,6.75675675675676,19.5945945945946,22.972972972973,9.45945945945946,41.2162162162162,4.72972972972973,8.78378378378378,24.3243243243243,3.37837837837838
"E00021617",152,10,11,90,41,94,7,10,53,24,58,3,1,37,17,6.57894736842105,7.23684210526316,59.2105263157895,26.9736842105263,61.8421052631579,4.60526315789474,6.57894736842105,34.8684210526316,15.7894736842105,38.1578947368421,1.97368421052632,0.657894736842105,24.3421052631579,11.1842105263158
"E00021618",84,12,22,40,10,55,8,17,23,7,29,4,5,17,3,14.2857142857143,26.1904761904762,47.6190476190476,11.9047619047619,65.4761904761905,9.52380952380952,20.2380952380952,27.3809523809524,8.33333333333333,34.5238095238095,4.76190476190476,5.95238095238095,20.2380952380952,3.57142857142857
"E00021619",175,13,56,86,20,120,8,41,56,15,55,5,15,30,5,7.42857142857143,32,49.1428571428571,11.4285714285714,68.5714285714286,4.57142857142857,23.4285714285714,32,8.57142857142857,31.4285714285714,2.85714285714286,8.57142857142857,17.1428571428571,2.85714285714286
"E00021620",132,7,24,72,29,82,3,9,47,23,50,4,15,25,6,5.3030303030303,18.1818181818182,54.5454545454545,21.969696969697,62.1212121212121,2.27272727272727,6.81818181818182,35.6060606060606,17.4242424242424,37.8787878787879,3.03030303030303,11.3636363636364,18.9393939393939,4.54545454545455
"E00021621",108,11,40,49,8,65,5,25,30,5,43,6,15,19,3,10.1851851851852,37.037037037037,45.3703703703704,7.40740740740741,60.1851851851852,4.62962962962963,23.1481481481481,27.7777777777778,4.62962962962963,39.8148148148148,5.55555555555556,13.8888888888889,17.5925925925926,2.77777777777778
"E00021622",202,6,11,105,80,118,1,5,56,56,84,5,6,49,24,2.97029702970297,5.44554455445545,51.980198019802,39.6039603960396,58.4158415841584,0.495049504950495,2.47524752475248,27.7227722772277,27.7227722772277,41.5841584158416,2.47524752475248,2.97029702970297,24.2574257425743,11.8811881188119
"E00021623",67,5,21,30,11,37,2,13,14,8,30,3,8,16,3,7.46268656716418,31.3432835820896,44.7761194029851,16.4179104477612,55.2238805970149,2.98507462686567,19.4029850746269,20.8955223880597,11.9402985074627,44.7761194029851,4.47761194029851,11.9402985074627,23.8805970149254,4.47761194029851
"E00021624",226,8,14,133,71,132,5,7,72,48,94,3,7,61,23,3.53982300884956,6.19469026548673,58.8495575221239,31.4159292035398,58.4070796460177,2.21238938053097,3.09734513274336,31.858407079646,21.2389380530973,41.5929203539823,1.32743362831858,3.09734513274336,26.9911504424779,10.1769911504425
"E00021625",362,17,18,194,133,221,9,9,102,101,141,8,9,92,32,4.69613259668508,4.97237569060773,53.5911602209945,36.7403314917127,61.0497237569061,2.48618784530387,2.48618784530387,28.1767955801105,27.9005524861878,38.9502762430939,2.20994475138122,2.48618784530387,25.414364640884,8.83977900552486
"E00021626",234,6,8,129,91,148,3,6,74,65,86,3,2,55,26,2.56410256410256,3.41880341880342,55.1282051282051,38.8888888888889,63.2478632478632,1.28205128205128,2.56410256410256,31.6239316239316,27.7777777777778,36.7521367521368,1.28205128205128,0.854700854700855,23.5042735042735,11.1111111111111
"E00021627",286,10,15,176,85,171,6,7,100,58,115,4,8,76,27,3.4965034965035,5.24475524475525,61.5384615384615,29.7202797202797,59.7902097902098,2.0979020979021,2.44755244755245,34.965034965035,20.2797202797203,40.2097902097902,1.3986013986014,2.7972027972028,26.5734265734266,9.44055944055944
"E00021628",143,4,13,84,42,89,1,7,50,31,54,3,6,34,11,2.7972027972028,9.09090909090909,58.7412587412587,29.3706293706294,62.2377622377622,0.699300699300699,4.89510489510489,34.965034965035,21.6783216783217,37.7622377622378,2.0979020979021,4.1958041958042,23.7762237762238,7.69230769230769
"E00021629",181,11,14,101,55,87,4,1,54,28,94,7,13,47,27,6.07734806629834,7.73480662983425,55.8011049723757,30.3867403314917,48.0662983425414,2.20994475138122,0.552486187845304,29.8342541436464,15.4696132596685,51.9337016574586,3.86740331491713,7.18232044198895,25.9668508287293,14.9171270718232
"E00021630",137,11,22,85,19,67,3,10,45,9,70,8,12,40,10,8.02919708029197,16.0583941605839,62.043795620438,13.8686131386861,48.9051094890511,2.18978102189781,7.2992700729927,32.8467153284672,6.56934306569343,51.0948905109489,5.83941605839416,8.75912408759124,29.1970802919708,7.2992700729927
"E00021631",230,8,15,146,61,116,3,6,72,35,114,5,9,74,26,3.47826086956522,6.52173913043478,63.4782608695652,26.5217391304348,50.4347826086956,1.30434782608696,2.60869565217391,31.304347826087,15.2173913043478,49.5652173913044,2.17391304347826,3.91304347826087,32.1739130434783,11.304347826087
"E00021632",193,7,8,103,75,113,4,1,57,51,80,3,7,46,24,3.62694300518135,4.14507772020725,53.3678756476684,38.860103626943,58.5492227979275,2.07253886010363,0.518134715025907,29.5336787564767,26.4248704663212,41.4507772020725,1.55440414507772,3.62694300518135,23.8341968911917,12.4352331606218
"E00021633",168,5,15,72,76,99,3,7,40,49,69,2,8,32,27,2.97619047619048,8.92857142857143,42.8571428571429,45.2380952380952,58.9285714285714,1.78571428571429,4.16666666666667,23.8095238095238,29.1666666666667,41.0714285714286,1.19047619047619,4.76190476190476,19.047619047619,16.0714285714286
"E00021634",190,5,18,105,62,110,1,10,60,39,80,4,8,45,23,2.63157894736842,9.47368421052632,55.2631578947368,32.6315789473684,57.8947368421053,0.526315789473684,5.26315789473684,31.5789473684211,20.5263157894737,42.1052631578947,2.10526315789474,4.21052631578947,23.6842105263158,12.1052631578947
"E00021635",172,2,9,103,58,107,1,4,58,44,65,1,5,45,14,1.16279069767442,5.23255813953488,59.8837209302326,33.7209302325581,62.2093023255814,0.581395348837209,2.32558139534884,33.7209302325581,25.5813953488372,37.7906976744186,0.581395348837209,2.90697674418605,26.1627906976744,8.13953488372093
"E00021636",128,12,32,68,16,82,4,20,47,11,46,8,12,21,5,9.375,25,53.125,12.5,64.0625,3.125,15.625,36.71875,8.59375,35.9375,6.25,9.375,16.40625,3.90625
"E00021637",188,14,44,104,26,116,9,29,59,19,72,5,15,45,7,7.4468085106383,23.4042553191489,55.3191489361702,13.8297872340426,61.7021276595745,4.78723404255319,15.4255319148936,31.3829787234043,10.1063829787234,38.2978723404255,2.65957446808511,7.97872340425532,23.936170212766,3.72340425531915
"E00021639",103,19,24,48,12,73,13,21,29,10,30,6,3,19,2,18.4466019417476,23.3009708737864,46.6019417475728,11.6504854368932,70.873786407767,12.621359223301,20.3883495145631,28.1553398058252,9.70873786407767,29.126213592233,5.8252427184466,2.9126213592233,18.4466019417476,1.94174757281553
"E00021640",147,24,41,68,14,84,7,25,41,11,63,17,16,27,3,16.3265306122449,27.891156462585,46.2585034013605,9.52380952380952,57.1428571428571,4.76190476190476,17.0068027210884,27.891156462585,7.48299319727891,42.8571428571429,11.5646258503401,10.8843537414966,18.3673469387755,2.04081632653061
"E00021641",162,18,35,85,24,104,8,26,50,20,58,10,9,35,4,11.1111111111111,21.6049382716049,52.4691358024691,14.8148148148148,64.1975308641975,4.93827160493827,16.0493827160494,30.8641975308642,12.3456790123457,35.8024691358025,6.17283950617284,5.55555555555556,21.6049382716049,2.46913580246914
"E00021642",109,17,39,39,14,75,13,29,24,9,34,4,10,15,5,15.5963302752294,35.7798165137615,35.7798165137615,12.8440366972477,68.8073394495413,11.9266055045872,26.605504587156,22.0183486238532,8.25688073394496,31.1926605504587,3.6697247706422,9.1743119266055,13.7614678899083,4.58715596330275
"E00021643",97,20,16,42,19,58,12,9,22,15,39,8,7,20,4,20.6185567010309,16.4948453608247,43.298969072165,19.5876288659794,59.7938144329897,12.3711340206186,9.27835051546392,22.680412371134,15.4639175257732,40.2061855670103,8.24742268041237,7.21649484536082,20.6185567010309,4.12371134020619
"E00021644",127,13,29,67,18,73,4,12,43,14,54,9,17,24,4,10.2362204724409,22.8346456692913,52.755905511811,14.1732283464567,57.4803149606299,3.1496062992126,9.44881889763779,33.8582677165354,11.0236220472441,42.5196850393701,7.08661417322835,13.3858267716535,18.8976377952756,3.1496062992126
"E00021646",162,16,54,79,13,101,5,38,48,10,61,11,16,31,3,9.87654320987654,33.3333333333333,48.7654320987654,8.02469135802469,62.3456790123457,3.08641975308642,23.4567901234568,29.6296296296296,6.17283950617284,37.6543209876543,6.79012345679012,9.87654320987654,19.1358024691358,1.85185185185185
"E00021648",164,6,19,91,48,101,3,11,56,31,63,3,8,35,17,3.65853658536585,11.5853658536585,55.4878048780488,29.2682926829268,61.5853658536585,1.82926829268293,6.70731707317073,34.1463414634146,18.9024390243902,38.4146341463415,1.82926829268293,4.8780487804878,21.3414634146341,10.3658536585366
"E00021649",161,24,44,79,14,94,16,29,42,7,67,8,15,37,7,14.9068322981366,27.3291925465839,49.0683229813665,8.69565217391304,58.3850931677019,9.93788819875776,18.0124223602484,26.0869565217391,4.34782608695652,41.6149068322981,4.96894409937888,9.3167701863354,22.9813664596273,4.34782608695652
"E00021650",157,8,16,83,50,107,4,12,55,36,50,4,4,28,14,5.09554140127389,10.1910828025478,52.8662420382166,31.8471337579618,68.1528662420382,2.54777070063694,7.64331210191083,35.031847133758,22.9299363057325,31.8471337579618,2.54777070063694,2.54777070063694,17.8343949044586,8.9171974522293
"E00021651",181,6,10,100,65,108,3,6,54,45,73,3,4,46,20,3.31491712707182,5.52486187845304,55.2486187845304,35.9116022099448,59.6685082872928,1.65745856353591,3.31491712707182,29.8342541436464,24.8618784530387,40.3314917127072,1.65745856353591,2.20994475138122,25.414364640884,11.0497237569061
"E00021652",204,2,5,105,92,128,1,1,62,64,76,1,4,43,28,0.980392156862745,2.45098039215686,51.4705882352941,45.0980392156863,62.7450980392157,0.490196078431373,0.490196078431373,30.3921568627451,31.3725490196078,37.2549019607843,0.490196078431373,1.96078431372549,21.078431372549,13.7254901960784
"E00021653",190,28,62,81,19,129,16,47,53,13,61,12,15,28,6,14.7368421052632,32.6315789473684,42.6315789473684,10,67.8947368421053,8.42105263157895,24.7368421052632,27.8947368421053,6.8421052631579,32.1052631578947,6.31578947368421,7.89473684210526,14.7368421052632,3.15789473684211
"E00021654",126,19,33,57,17,73,7,17,33,16,53,12,16,24,1,15.0793650793651,26.1904761904762,45.2380952380952,13.4920634920635,57.9365079365079,5.55555555555556,13.4920634920635,26.1904761904762,12.6984126984127,42.0634920634921,9.52380952380952,12.6984126984127,19.047619047619,0.793650793650794
"E00021655",74,9,22,37,6,53,5,19,24,5,21,4,3,13,1,12.1621621621622,29.7297297297297,50,8.10810810810811,71.6216216216216,6.75675675675676,25.6756756756757,32.4324324324324,6.75675675675676,28.3783783783784,5.40540540540541,4.05405405405405,17.5675675675676,1.35135135135135
"E00021656",159,28,25,84,22,81,13,12,40,16,78,15,13,44,6,17.6100628930818,15.7232704402516,52.8301886792453,13.8364779874214,50.9433962264151,8.17610062893082,7.54716981132075,25.1572327044025,10.062893081761,49.0566037735849,9.43396226415094,8.17610062893082,27.6729559748428,3.77358490566038
"E00021657",164,7,4,94,59,99,4,1,57,37,65,3,3,37,22,4.26829268292683,2.4390243902439,57.3170731707317,35.9756097560976,60.3658536585366,2.4390243902439,0.609756097560976,34.7560975609756,22.5609756097561,39.6341463414634,1.82926829268293,1.82926829268293,22.5609756097561,13.4146341463415
"E00021658",129,4,7,62,56,84,2,1,39,42,45,2,6,23,14,3.10077519379845,5.42635658914729,48.062015503876,43.4108527131783,65.1162790697674,1.55038759689922,0.775193798449612,30.2325581395349,32.5581395348837,34.8837209302326,1.55038759689922,4.65116279069767,17.8294573643411,10.8527131782946
"E00021659",135,17,19,80,19,91,11,12,53,15,44,6,7,27,4,12.5925925925926,14.0740740740741,59.2592592592593,14.0740740740741,67.4074074074074,8.14814814814815,8.88888888888889,39.2592592592593,11.1111111111111,32.5925925925926,4.44444444444444,5.18518518518519,20,2.96296296296296
"E00021660",121,11,18,71,21,71,6,12,39,14,50,5,6,32,7,9.09090909090909,14.8760330578512,58.6776859504132,17.3553719008264,58.6776859504132,4.95867768595041,9.91735537190083,32.2314049586777,11.5702479338843,41.3223140495868,4.13223140495868,4.95867768595041,26.4462809917355,5.78512396694215
"E00021661",232,26,31,136,39,125,8,20,75,22,107,18,11,61,17,11.2068965517241,13.3620689655172,58.6206896551724,16.8103448275862,53.8793103448276,3.44827586206897,8.62068965517241,32.3275862068966,9.48275862068965,46.1206896551724,7.75862068965517,4.74137931034483,26.2931034482759,7.32758620689655
"E00021662",227,28,61,111,27,133,11,39,63,20,94,17,22,48,7,12.3348017621145,26.8722466960352,48.8986784140969,11.8942731277533,58.5903083700441,4.84581497797357,17.1806167400881,27.7533039647577,8.81057268722467,41.4096916299559,7.48898678414097,9.69162995594714,21.1453744493392,3.08370044052863
"E00021663",100,19,13,61,7,57,11,10,31,5,43,8,3,30,2,19,13,61,7,57,11,10,31,5,43,8,3,30,2
"E00021665",126,20,45,50,11,85,9,28,40,8,41,11,17,10,3,15.8730158730159,35.7142857142857,39.6825396825397,8.73015873015873,67.4603174603175,7.14285714285714,22.2222222222222,31.7460317460317,6.34920634920635,32.5396825396825,8.73015873015873,13.4920634920635,7.93650793650794,2.38095238095238
"E00021666",268,21,46,128,73,170,9,27,76,58,98,12,19,52,15,7.83582089552239,17.1641791044776,47.7611940298507,27.2388059701493,63.4328358208955,3.35820895522388,10.0746268656716,28.3582089552239,21.6417910447761,36.5671641791045,4.47761194029851,7.08955223880597,19.4029850746269,5.59701492537313
"E00021667",146,22,58,54,12,110,16,43,41,10,36,6,15,13,2,15.0684931506849,39.7260273972603,36.986301369863,8.21917808219178,75.3424657534247,10.958904109589,29.4520547945205,28.0821917808219,6.84931506849315,24.6575342465753,4.10958904109589,10.2739726027397,8.9041095890411,1.36986301369863
"E00021668",245,31,25,134,55,148,12,15,77,44,97,19,10,57,11,12.6530612244898,10.2040816326531,54.6938775510204,22.4489795918367,60.4081632653061,4.89795918367347,6.12244897959184,31.4285714285714,17.9591836734694,39.5918367346939,7.75510204081633,4.08163265306122,23.265306122449,4.48979591836735
"E00021669",125,12,53,56,4,87,4,43,39,1,38,8,10,17,3,9.6,42.4,44.8,3.2,69.6,3.2,34.4,31.2,0.8,30.4,6.4,8,13.6,2.4
"E00021670",117,12,42,52,11,76,5,30,31,10,41,7,12,21,1,10.2564102564103,35.8974358974359,44.4444444444444,9.4017094017094,64.957264957265,4.27350427350427,25.6410256410256,26.4957264957265,8.54700854700855,35.042735042735,5.98290598290598,10.2564102564103,17.9487179487179,0.854700854700855
"E00021671",105,13,27,55,10,63,6,15,34,8,42,7,12,21,2,12.3809523809524,25.7142857142857,52.3809523809524,9.52380952380952,60,5.71428571428571,14.2857142857143,32.3809523809524,7.61904761904762,40,6.66666666666667,11.4285714285714,20,1.9047619047619
"E00021672",190,13,29,104,44,126,7,19,65,35,64,6,10,39,9,6.8421052631579,15.2631578947368,54.7368421052632,23.1578947368421,66.3157894736842,3.68421052631579,10,34.2105263157895,18.4210526315789,33.6842105263158,3.15789473684211,5.26315789473684,20.5263157894737,4.73684210526316
"E00021673",128,17,29,57,25,87,12,18,36,21,41,5,11,21,4,13.28125,22.65625,44.53125,19.53125,67.96875,9.375,14.0625,28.125,16.40625,32.03125,3.90625,8.59375,16.40625,3.125
"E00021674",217,22,36,123,36,138,12,22,77,27,79,10,14,46,9,10.1382488479263,16.5898617511521,56.6820276497696,16.5898617511521,63.594470046083,5.52995391705069,10.1382488479263,35.4838709677419,12.4423963133641,36.405529953917,4.60829493087558,6.45161290322581,21.1981566820277,4.14746543778802
"E00021675",161,23,59,70,9,97,10,38,43,6,64,13,21,27,3,14.2857142857143,36.6459627329193,43.4782608695652,5.59006211180124,60.2484472049689,6.2111801242236,23.6024844720497,26.7080745341615,3.72670807453416,39.7515527950311,8.07453416149068,13.0434782608696,16.7701863354037,1.86335403726708
"E00021676",231,11,13,119,88,142,7,6,66,63,89,4,7,53,25,4.76190476190476,5.62770562770563,51.5151515151515,38.0952380952381,61.4718614718615,3.03030303030303,2.5974025974026,28.5714285714286,27.2727272727273,38.5281385281385,1.73160173160173,3.03030303030303,22.9437229437229,10.8225108225108
"E00021677",147,19,37,76,15,93,10,26,48,9,54,9,11,28,6,12.9251700680272,25.1700680272109,51.7006802721088,10.2040816326531,63.265306122449,6.80272108843537,17.687074829932,32.6530612244898,6.12244897959184,36.734693877551,6.12244897959184,7.48299319727891,19.047619047619,4.08163265306122
"E00021678",233,21,29,147,36,119,5,21,72,21,114,16,8,75,15,9.01287553648069,12.4463519313305,63.0901287553648,15.450643776824,51.0729613733906,2.14592274678112,9.01287553648069,30.9012875536481,9.01287553648069,48.9270386266094,6.86695278969957,3.43347639484979,32.1888412017167,6.43776824034335
"E00021679",87,5,9,55,18,60,4,8,40,8,27,1,1,15,10,5.74712643678161,10.3448275862069,63.2183908045977,20.6896551724138,68.9655172413793,4.59770114942529,9.19540229885057,45.9770114942529,9.19540229885057,31.0344827586207,1.14942528735632,1.14942528735632,17.2413793103448,11.4942528735632
"E00021680",283,27,28,129,99,182,17,12,83,70,101,10,16,46,29,9.54063604240283,9.89399293286219,45.583038869258,34.982332155477,64.3109540636042,6.00706713780919,4.24028268551237,29.3286219081272,24.7349823321555,35.6890459363958,3.53356890459364,5.65371024734982,16.2544169611307,10.2473498233216
"E00021681",191,5,11,98,77,125,1,6,63,55,66,4,5,35,22,2.61780104712042,5.75916230366492,51.3089005235602,40.3141361256544,65.4450261780105,0.523560209424084,3.1413612565445,32.9842931937173,28.7958115183246,34.5549738219895,2.09424083769634,2.61780104712042,18.3246073298429,11.5183246073298
"E00021682",211,29,53,112,17,136,18,41,66,11,75,11,12,46,6,13.7440758293839,25.1184834123223,53.0805687203791,8.05687203791469,64.4549763033175,8.53080568720379,19.4312796208531,31.2796208530806,5.21327014218009,35.5450236966825,5.21327014218009,5.68720379146919,21.8009478672986,2.8436018957346
"E00021683",192,32,54,79,27,134,25,35,54,20,58,7,19,25,7,16.6666666666667,28.125,41.1458333333333,14.0625,69.7916666666667,13.0208333333333,18.2291666666667,28.125,10.4166666666667,30.2083333333333,3.64583333333333,9.89583333333333,13.0208333333333,3.64583333333333
"E00021685",286,27,43,149,67,169,17,28,75,49,117,10,15,74,18,9.44055944055944,15.034965034965,52.0979020979021,23.4265734265734,59.0909090909091,5.94405594405594,9.79020979020979,26.2237762237762,17.1328671328671,40.9090909090909,3.4965034965035,5.24475524475525,25.8741258741259,6.29370629370629
"E00021686",244,32,23,110,79,136,12,10,60,54,108,20,13,50,25,13.1147540983607,9.42622950819672,45.0819672131148,32.3770491803279,55.7377049180328,4.91803278688525,4.0983606557377,24.5901639344262,22.1311475409836,44.2622950819672,8.19672131147541,5.32786885245902,20.4918032786885,10.2459016393443
"E00021687",296,12,22,165,97,166,1,16,82,67,130,11,6,83,30,4.05405405405405,7.43243243243243,55.7432432432432,32.7702702702703,56.0810810810811,0.337837837837838,5.40540540540541,27.7027027027027,22.6351351351351,43.9189189189189,3.71621621621622,2.02702702702703,28.0405405405405,10.1351351351351
"E00021688",183,22,35,98,28,105,14,13,59,19,78,8,22,39,9,12.0218579234973,19.1256830601093,53.551912568306,15.3005464480874,57.3770491803279,7.65027322404372,7.10382513661202,32.2404371584699,10.3825136612022,42.6229508196721,4.37158469945355,12.0218579234973,21.3114754098361,4.91803278688525
"E00021689",241,14,24,110,93,140,8,8,60,64,101,6,16,50,29,5.80912863070539,9.95850622406639,45.643153526971,38.5892116182573,58.0912863070539,3.3195020746888,3.3195020746888,24.896265560166,26.5560165975104,41.9087136929461,2.4896265560166,6.63900414937759,20.746887966805,12.0331950207469
"E00021690",275,25,36,157,57,171,11,25,97,38,104,14,11,60,19,9.09090909090909,13.0909090909091,57.0909090909091,20.7272727272727,62.1818181818182,4,9.09090909090909,35.2727272727273,13.8181818181818,37.8181818181818,5.09090909090909,4,21.8181818181818,6.90909090909091
"E00021691",146,13,37,68,28,81,3,16,41,21,65,10,21,27,7,8.9041095890411,25.3424657534247,46.5753424657534,19.1780821917808,55.4794520547945,2.05479452054794,10.958904109589,28.0821917808219,14.3835616438356,44.5205479452055,6.84931506849315,14.3835616438356,18.4931506849315,4.79452054794521
"E00021692",202,6,15,92,89,132,3,9,54,66,70,3,6,38,23,2.97029702970297,7.42574257425743,45.5445544554455,44.0594059405941,65.3465346534654,1.48514851485149,4.45544554455445,26.7326732673267,32.6732673267327,34.6534653465347,1.48514851485149,2.97029702970297,18.8118811881188,11.3861386138614
"E00021693",258,12,45,132,69,140,6,20,71,43,118,6,25,61,26,4.65116279069767,17.4418604651163,51.1627906976744,26.7441860465116,54.2635658914729,2.32558139534884,7.75193798449612,27.5193798449612,16.6666666666667,45.7364341085271,2.32558139534884,9.68992248062016,23.6434108527132,10.077519379845
"E00021694",198,16,47,109,26,125,11,30,64,20,73,5,17,45,6,8.08080808080808,23.7373737373737,55.0505050505051,13.1313131313131,63.1313131313131,5.55555555555556,15.1515151515152,32.3232323232323,10.1010101010101,36.8686868686869,2.52525252525253,8.58585858585858,22.7272727272727,3.03030303030303
"E00021695",233,11,27,131,64,140,7,16,76,41,93,4,11,55,23,4.72103004291846,11.587982832618,56.2231759656652,27.4678111587983,60.0858369098712,3.00429184549356,6.86695278969957,32.618025751073,17.5965665236052,39.9141630901288,1.71673819742489,4.72103004291846,23.6051502145923,9.87124463519313
"E00021696",252,24,41,126,61,159,14,21,76,48,93,10,20,50,13,9.52380952380952,16.2698412698413,50,24.2063492063492,63.0952380952381,5.55555555555556,8.33333333333333,30.1587301587302,19.047619047619,36.9047619047619,3.96825396825397,7.93650793650794,19.8412698412698,5.15873015873016
"E00021697",149,10,34,84,21,93,6,16,60,11,56,4,18,24,10,6.71140939597315,22.8187919463087,56.3758389261745,14.0939597315436,62.4161073825503,4.02684563758389,10.738255033557,40.2684563758389,7.38255033557047,37.5838926174497,2.68456375838926,12.0805369127517,16.1073825503356,6.71140939597315
"E00021698",204,16,22,112,54,106,4,10,53,39,98,12,12,59,15,7.84313725490196,10.7843137254902,54.9019607843137,26.4705882352941,51.9607843137255,1.96078431372549,4.90196078431373,25.9803921568627,19.1176470588235,48.0392156862745,5.88235294117647,5.88235294117647,28.921568627451,7.35294117647059
"E00021699",174,19,32,102,21,107,9,22,60,16,67,10,10,42,5,10.9195402298851,18.3908045977011,58.6206896551724,12.0689655172414,61.4942528735632,5.17241379310345,12.6436781609195,34.4827586206897,9.19540229885057,38.5057471264368,5.74712643678161,5.74712643678161,24.1379310344828,2.8735632183908
"E00021700",306,21,42,148,95,175,5,26,82,62,131,16,16,66,33,6.86274509803922,13.7254901960784,48.3660130718954,31.0457516339869,57.1895424836601,1.63398692810458,8.49673202614379,26.797385620915,20.2614379084967,42.8104575163399,5.22875816993464,5.22875816993464,21.5686274509804,10.7843137254902
"E00021701",277,14,32,163,68,153,5,16,91,41,124,9,16,72,27,5.05415162454874,11.5523465703971,58.8447653429603,24.5487364620939,55.2346570397112,1.80505415162455,5.77617328519856,32.8519855595668,14.8014440433213,44.7653429602888,3.24909747292419,5.77617328519856,25.9927797833935,9.74729241877256
"E00021702",115,5,24,73,13,55,1,11,35,8,60,4,13,38,5,4.34782608695652,20.8695652173913,63.4782608695652,11.304347826087,47.8260869565217,0.869565217391304,9.56521739130435,30.4347826086957,6.95652173913043,52.1739130434783,3.47826086956522,11.304347826087,33.0434782608696,4.34782608695652
"E00021703",144,9,25,91,19,80,5,12,53,10,64,4,13,38,9,6.25,17.3611111111111,63.1944444444444,13.1944444444444,55.5555555555556,3.47222222222222,8.33333333333333,36.8055555555556,6.94444444444444,44.4444444444444,2.77777777777778,9.02777777777778,26.3888888888889,6.25
"E00021704",190,9,31,114,36,102,4,20,58,20,88,5,11,56,16,4.73684210526316,16.3157894736842,60,18.9473684210526,53.6842105263158,2.10526315789474,10.5263157894737,30.5263157894737,10.5263157894737,46.3157894736842,2.63157894736842,5.78947368421053,29.4736842105263,8.42105263157895
"E00021705",205,10,38,128,29,111,4,23,62,22,94,6,15,66,7,4.8780487804878,18.5365853658537,62.4390243902439,14.1463414634146,54.1463414634146,1.95121951219512,11.219512195122,30.2439024390244,10.7317073170732,45.8536585365854,2.92682926829268,7.31707317073171,32.1951219512195,3.41463414634146
"E00021706",135,18,24,71,22,90,9,20,46,15,45,9,4,25,7,13.3333333333333,17.7777777777778,52.5925925925926,16.2962962962963,66.6666666666667,6.66666666666667,14.8148148148148,34.0740740740741,11.1111111111111,33.3333333333333,6.66666666666667,2.96296296296296,18.5185185185185,5.18518518518519
"E00021707",178,18,44,103,13,96,10,22,53,11,82,8,22,50,2,10.1123595505618,24.7191011235955,57.8651685393258,7.30337078651685,53.9325842696629,5.61797752808989,12.3595505617978,29.7752808988764,6.17977528089888,46.0674157303371,4.49438202247191,12.3595505617978,28.0898876404494,1.12359550561798
"E00021708",149,18,21,89,21,79,7,8,52,12,70,11,13,37,9,12.0805369127517,14.0939597315436,59.7315436241611,14.0939597315436,53.0201342281879,4.69798657718121,5.36912751677852,34.8993288590604,8.05369127516778,46.9798657718121,7.38255033557047,8.7248322147651,24.8322147651007,6.04026845637584
"E00021709",150,11,45,86,8,107,4,35,60,8,43,7,10,26,0,7.33333333333333,30,57.3333333333333,5.33333333333333,71.3333333333333,2.66666666666667,23.3333333333333,40,5.33333333333333,28.6666666666667,4.66666666666667,6.66666666666667,17.3333333333333,0
"E00021710",130,14,21,79,16,61,3,14,34,10,69,11,7,45,6,10.7692307692308,16.1538461538462,60.7692307692308,12.3076923076923,46.9230769230769,2.30769230769231,10.7692307692308,26.1538461538462,7.69230769230769,53.0769230769231,8.46153846153846,5.38461538461539,34.6153846153846,4.61538461538462
"E00021711",265,22,31,156,56,142,12,19,74,37,123,10,12,82,19,8.30188679245283,11.6981132075472,58.8679245283019,21.1320754716981,53.5849056603774,4.52830188679245,7.16981132075472,27.9245283018868,13.9622641509434,46.4150943396226,3.77358490566038,4.52830188679245,30.9433962264151,7.16981132075472
"E00021712",202,12,27,123,40,118,6,11,77,24,84,6,16,46,16,5.94059405940594,13.3663366336634,60.8910891089109,19.8019801980198,58.4158415841584,2.97029702970297,5.44554455445545,38.1188118811881,11.8811881188119,41.5841584158416,2.97029702970297,7.92079207920792,22.7722772277228,7.92079207920792
"E00021713",109,7,23,72,7,68,2,12,48,6,41,5,11,24,1,6.42201834862385,21.1009174311927,66.0550458715596,6.42201834862385,62.3853211009174,1.8348623853211,11.0091743119266,44.0366972477064,5.5045871559633,37.6146788990826,4.58715596330275,10.0917431192661,22.0183486238532,0.917431192660551
"E00021714",100,13,26,49,12,61,6,16,30,9,39,7,10,19,3,13,26,49,12,61,6,16,30,9,39,7,10,19,3
"E00021715",149,24,32,78,15,79,8,14,49,8,70,16,18,29,7,16.1073825503356,21.4765100671141,52.3489932885906,10.0671140939597,53.0201342281879,5.36912751677852,9.39597315436242,32.8859060402685,5.36912751677852,46.9798657718121,10.738255033557,12.0805369127517,19.4630872483221,4.69798657718121
"E00021716",108,7,18,70,13,72,5,14,46,7,36,2,4,24,6,6.48148148148148,16.6666666666667,64.8148148148148,12.037037037037,66.6666666666667,4.62962962962963,12.962962962963,42.5925925925926,6.48148148148148,33.3333333333333,1.85185185185185,3.7037037037037,22.2222222222222,5.55555555555556
"E00021717",114,7,19,71,17,62,1,11,36,14,52,6,8,35,3,6.14035087719298,16.6666666666667,62.280701754386,14.9122807017544,54.3859649122807,0.87719298245614,9.64912280701754,31.5789473684211,12.280701754386,45.6140350877193,5.26315789473684,7.01754385964912,30.7017543859649,2.63157894736842
"E00021718",230,22,26,129,53,138,9,15,82,32,92,13,11,47,21,9.56521739130435,11.304347826087,56.0869565217391,23.0434782608696,60,3.91304347826087,6.52173913043478,35.6521739130435,13.9130434782609,40,5.65217391304348,4.78260869565217,20.4347826086957,9.1304347826087
"E00021719",72,4,15,42,11,47,3,10,26,8,25,1,5,16,3,5.55555555555556,20.8333333333333,58.3333333333333,15.2777777777778,65.2777777777778,4.16666666666667,13.8888888888889,36.1111111111111,11.1111111111111,34.7222222222222,1.38888888888889,6.94444444444444,22.2222222222222,4.16666666666667
"E00021722",204,26,50,109,19,126,19,33,63,11,78,7,17,46,8,12.7450980392157,24.5098039215686,53.4313725490196,9.31372549019608,61.7647058823529,9.31372549019608,16.1764705882353,30.8823529411765,5.3921568627451,38.2352941176471,3.43137254901961,8.33333333333333,22.5490196078431,3.92156862745098
"E00021723",137,6,23,84,24,78,2,12,48,16,59,4,11,36,8,4.37956204379562,16.7883211678832,61.3138686131387,17.5182481751825,56.9343065693431,1.45985401459854,8.75912408759124,35.036496350365,11.6788321167883,43.0656934306569,2.91970802919708,8.02919708029197,26.2773722627737,5.83941605839416
"E00021724",178,10,29,90,49,89,4,14,43,28,89,6,15,47,21,5.61797752808989,16.2921348314607,50.561797752809,27.5280898876405,50,2.24719101123596,7.86516853932584,24.1573033707865,15.7303370786517,50,3.37078651685393,8.42696629213483,26.4044943820225,11.7977528089888
"E00021725",146,6,12,83,45,77,2,6,42,27,69,4,6,41,18,4.10958904109589,8.21917808219178,56.8493150684932,30.8219178082192,52.7397260273973,1.36986301369863,4.10958904109589,28.7671232876712,18.4931506849315,47.2602739726027,2.73972602739726,4.10958904109589,28.0821917808219,12.3287671232877
"E00021726",92,11,25,49,7,57,5,17,31,4,35,6,8,18,3,11.9565217391304,27.1739130434783,53.2608695652174,7.60869565217391,61.9565217391304,5.43478260869565,18.4782608695652,33.695652173913,4.34782608695652,38.0434782608696,6.52173913043478,8.69565217391304,19.5652173913043,3.26086956521739
"E00021727",84,8,25,43,8,47,6,11,24,6,37,2,14,19,2,9.52380952380952,29.7619047619048,51.1904761904762,9.52380952380952,55.952380952381,7.14285714285714,13.0952380952381,28.5714285714286,7.14285714285714,44.047619047619,2.38095238095238,16.6666666666667,22.6190476190476,2.38095238095238
"E00021728",97,12,10,58,17,54,6,6,29,13,43,6,4,29,4,12.3711340206186,10.3092783505155,59.7938144329897,17.5257731958763,55.6701030927835,6.18556701030928,6.18556701030928,29.8969072164948,13.4020618556701,44.3298969072165,6.18556701030928,4.12371134020619,29.8969072164948,4.12371134020619
"E00021729",82,5,21,41,15,45,2,12,22,9,37,3,9,19,6,6.09756097560976,25.609756097561,50,18.2926829268293,54.8780487804878,2.4390243902439,14.6341463414634,26.8292682926829,10.9756097560976,45.1219512195122,3.65853658536585,10.9756097560976,23.1707317073171,7.31707317073171
"E00021730",154,18,29,90,17,86,5,15,55,11,68,13,14,35,6,11.6883116883117,18.8311688311688,58.4415584415584,11.038961038961,55.8441558441558,3.24675324675325,9.74025974025974,35.7142857142857,7.14285714285714,44.1558441558442,8.44155844155844,9.09090909090909,22.7272727272727,3.8961038961039
"E00021731",158,10,36,91,21,96,7,23,53,13,62,3,13,38,8,6.32911392405063,22.7848101265823,57.5949367088608,13.2911392405063,60.7594936708861,4.43037974683544,14.5569620253165,33.5443037974684,8.22784810126582,39.2405063291139,1.89873417721519,8.22784810126582,24.0506329113924,5.06329113924051
"E00021732",142,14,23,68,37,83,9,11,40,23,59,5,12,28,14,9.85915492957746,16.1971830985916,47.887323943662,26.056338028169,58.4507042253521,6.33802816901408,7.74647887323944,28.169014084507,16.1971830985916,41.5492957746479,3.52112676056338,8.45070422535211,19.7183098591549,9.85915492957746
"E00021733",332,22,48,200,62,202,15,34,110,43,130,7,14,90,19,6.62650602409639,14.4578313253012,60.2409638554217,18.6746987951807,60.8433734939759,4.51807228915663,10.2409638554217,33.1325301204819,12.9518072289157,39.1566265060241,2.10843373493976,4.21686746987952,27.1084337349398,5.72289156626506
"E00021734",191,28,44,96,23,121,17,23,64,17,70,11,21,32,6,14.6596858638743,23.0366492146597,50.261780104712,12.0418848167539,63.3507853403141,8.90052356020942,12.0418848167539,33.5078534031414,8.90052356020942,36.6492146596859,5.75916230366492,10.9947643979058,16.7539267015707,3.1413612565445
"E00021735",158,21,43,80,14,97,9,26,52,10,61,12,17,28,4,13.2911392405063,27.2151898734177,50.6329113924051,8.86075949367089,61.3924050632911,5.69620253164557,16.4556962025316,32.9113924050633,6.32911392405063,38.6075949367089,7.59493670886076,10.7594936708861,17.7215189873418,2.53164556962025
"E00021736",158,17,47,78,16,113,11,38,51,13,45,6,9,27,3,10.7594936708861,29.746835443038,49.3670886075949,10.126582278481,71.5189873417722,6.9620253164557,24.0506329113924,32.2784810126582,8.22784810126582,28.4810126582279,3.79746835443038,5.69620253164557,17.0886075949367,1.89873417721519
"E00021737",129,6,28,68,27,90,4,22,46,18,39,2,6,22,9,4.65116279069767,21.7054263565891,52.7131782945737,20.9302325581395,69.7674418604651,3.10077519379845,17.0542635658915,35.6589147286822,13.953488372093,30.2325581395349,1.55038759689922,4.65116279069767,17.0542635658915,6.97674418604651
"E00021738",125,18,32,53,22,74,7,20,30,17,51,11,12,23,5,14.4,25.6,42.4,17.6,59.2,5.6,16,24,13.6,40.8,8.8,9.6,18.4,4
"E00021739",176,11,20,106,39,103,3,14,61,25,73,8,6,45,14,6.25,11.3636363636364,60.2272727272727,22.1590909090909,58.5227272727273,1.70454545454545,7.95454545454545,34.6590909090909,14.2045454545455,41.4772727272727,4.54545454545455,3.40909090909091,25.5681818181818,7.95454545454545
"E00021740",169,16,41,94,18,107,9,25,61,12,62,7,16,33,6,9.46745562130178,24.2603550295858,55.6213017751479,10.6508875739645,63.3136094674556,5.32544378698225,14.792899408284,36.094674556213,7.10059171597633,36.6863905325444,4.14201183431953,9.46745562130178,19.5266272189349,3.55029585798817
"E00021741",196,3,6,113,74,117,3,3,61,50,79,0,3,52,24,1.53061224489796,3.06122448979592,57.6530612244898,37.7551020408163,59.6938775510204,1.53061224489796,1.53061224489796,31.1224489795918,25.5102040816327,40.3061224489796,0,1.53061224489796,26.530612244898,12.2448979591837
"E00021742",252,18,41,128,65,163,10,27,79,47,89,8,14,49,18,7.14285714285714,16.2698412698413,50.7936507936508,25.7936507936508,64.6825396825397,3.96825396825397,10.7142857142857,31.3492063492063,18.6507936507937,35.3174603174603,3.17460317460317,5.55555555555556,19.4444444444444,7.14285714285714
"E00021743",136,23,31,58,24,94,16,26,32,20,42,7,5,26,4,16.9117647058824,22.7941176470588,42.6470588235294,17.6470588235294,69.1176470588235,11.7647058823529,19.1176470588235,23.5294117647059,14.7058823529412,30.8823529411765,5.14705882352941,3.67647058823529,19.1176470588235,2.94117647058824
"E00021744",368,15,22,198,133,225,6,8,113,98,143,9,14,85,35,4.07608695652174,5.97826086956522,53.804347826087,36.1413043478261,61.1413043478261,1.6304347826087,2.17391304347826,30.7065217391304,26.6304347826087,38.8586956521739,2.44565217391304,3.80434782608696,23.0978260869565,9.51086956521739
"E00021745",89,7,26,49,7,52,5,15,29,3,37,2,11,20,4,7.86516853932584,29.2134831460674,55.0561797752809,7.86516853932584,58.4269662921348,5.61797752808989,16.8539325842697,32.5842696629214,3.37078651685393,41.5730337078652,2.24719101123596,12.3595505617978,22.4719101123595,4.49438202247191
"E00021746",193,8,18,110,57,105,2,8,61,34,88,6,10,49,23,4.14507772020725,9.32642487046632,56.9948186528497,29.5336787564767,54.4041450777202,1.03626943005181,4.14507772020725,31.6062176165803,17.6165803108808,45.5958549222798,3.10880829015544,5.18134715025907,25.3886010362694,11.9170984455959
"E00021748",274,39,44,137,54,180,17,36,87,40,94,22,8,50,14,14.2335766423358,16.0583941605839,50,19.7080291970803,65.6934306569343,6.2043795620438,13.1386861313869,31.7518248175182,14.5985401459854,34.3065693430657,8.02919708029197,2.91970802919708,18.2481751824818,5.10948905109489
"E00021750",139,19,52,53,15,90,7,37,33,13,49,12,15,20,2,13.6690647482014,37.410071942446,38.1294964028777,10.7913669064748,64.7482014388489,5.03597122302158,26.6187050359712,23.7410071942446,9.35251798561151,35.2517985611511,8.63309352517986,10.7913669064748,14.3884892086331,1.43884892086331
"E00021752",149,18,32,84,15,97,4,23,58,12,52,14,9,26,3,12.0805369127517,21.4765100671141,56.3758389261745,10.0671140939597,65.1006711409396,2.68456375838926,15.4362416107383,38.9261744966443,8.05369127516778,34.8993288590604,9.39597315436242,6.04026845637584,17.4496644295302,2.01342281879195
"E00021753",96,21,23,44,8,56,13,14,24,5,40,8,9,20,3,21.875,23.9583333333333,45.8333333333333,8.33333333333333,58.3333333333333,13.5416666666667,14.5833333333333,25,5.20833333333333,41.6666666666667,8.33333333333333,9.375,20.8333333333333,3.125
"E00021754",68,10,13,36,9,34,2,7,18,7,34,8,6,18,2,14.7058823529412,19.1176470588235,52.9411764705882,13.2352941176471,50,2.94117647058824,10.2941176470588,26.4705882352941,10.2941176470588,50,11.7647058823529,8.82352941176471,26.4705882352941,2.94117647058824
"E00021755",193,25,35,106,27,113,15,22,58,18,80,10,13,48,9,12.9533678756477,18.1347150259067,54.9222797927461,13.9896373056995,58.5492227979275,7.7720207253886,11.3989637305699,30.0518134715026,9.32642487046632,41.4507772020725,5.18134715025907,6.73575129533679,24.8704663212435,4.66321243523316
"E00021756",119,8,14,75,22,67,5,12,36,14,52,3,2,39,8,6.72268907563025,11.7647058823529,63.0252100840336,18.4873949579832,56.3025210084034,4.20168067226891,10.0840336134454,30.2521008403361,11.7647058823529,43.6974789915966,2.52100840336134,1.68067226890756,32.7731092436975,6.72268907563025
"E00021757",83,9,23,43,8,56,3,15,30,8,27,6,8,13,0,10.8433734939759,27.710843373494,51.8072289156626,9.63855421686747,67.4698795180723,3.6144578313253,18.0722891566265,36.144578313253,9.63855421686747,32.5301204819277,7.2289156626506,9.63855421686747,15.6626506024096,0
"E00021758",157,18,30,93,16,94,10,18,52,14,63,8,12,41,2,11.4649681528662,19.1082802547771,59.2356687898089,10.1910828025478,59.8726114649682,6.36942675159236,11.4649681528662,33.1210191082803,8.9171974522293,40.1273885350318,5.09554140127389,7.64331210191083,26.1146496815287,1.27388535031847
"E00021759",138,21,46,61,10,85,11,30,39,5,53,10,16,22,5,15.2173913043478,33.3333333333333,44.2028985507246,7.2463768115942,61.5942028985507,7.97101449275362,21.7391304347826,28.2608695652174,3.6231884057971,38.4057971014493,7.2463768115942,11.5942028985507,15.9420289855072,3.6231884057971
"E00021760",111,13,40,49,9,71,5,31,30,5,40,8,9,19,4,11.7117117117117,36.036036036036,44.1441441441441,8.10810810810811,63.963963963964,4.5045045045045,27.9279279279279,27.027027027027,4.5045045045045,36.036036036036,7.20720720720721,8.10810810810811,17.1171171171171,3.6036036036036
"E00021761",136,12,8,92,24,77,3,5,50,19,59,9,3,42,5,8.82352941176471,5.88235294117647,67.6470588235294,17.6470588235294,56.6176470588235,2.20588235294118,3.67647058823529,36.7647058823529,13.9705882352941,43.3823529411765,6.61764705882353,2.20588235294118,30.8823529411765,3.67647058823529
"E00021762",140,21,29,78,12,81,9,17,44,11,59,12,12,34,1,15,20.7142857142857,55.7142857142857,8.57142857142857,57.8571428571429,6.42857142857143,12.1428571428571,31.4285714285714,7.85714285714286,42.1428571428571,8.57142857142857,8.57142857142857,24.2857142857143,0.714285714285714
"E00021763",156,21,39,78,18,86,12,18,47,9,70,9,21,31,9,13.4615384615385,25,50,11.5384615384615,55.1282051282051,7.69230769230769,11.5384615384615,30.1282051282051,5.76923076923077,44.8717948717949,5.76923076923077,13.4615384615385,19.8717948717949,5.76923076923077
"E00021764",243,32,37,142,32,130,12,19,79,20,113,20,18,63,12,13.1687242798354,15.2263374485597,58.4362139917695,13.1687242798354,53.4979423868313,4.93827160493827,7.81893004115226,32.5102880658436,8.23045267489712,46.5020576131687,8.23045267489712,7.40740740740741,25.9259259259259,4.93827160493827
"E00021766",158,13,26,87,32,93,7,18,47,21,65,6,8,40,11,8.22784810126582,16.4556962025316,55.0632911392405,20.253164556962,58.8607594936709,4.43037974683544,11.3924050632911,29.746835443038,13.2911392405063,41.1392405063291,3.79746835443038,5.06329113924051,25.3164556962025,6.9620253164557
"E00021767",120,14,17,74,15,67,6,9,40,12,53,8,8,34,3,11.6666666666667,14.1666666666667,61.6666666666667,12.5,55.8333333333333,5,7.5,33.3333333333333,10,44.1666666666667,6.66666666666667,6.66666666666667,28.3333333333333,2.5
"E00167078",226,47,34,98,47,129,12,18,63,36,97,35,16,35,11,20.7964601769912,15.0442477876106,43.3628318584071,20.7964601769912,57.0796460176991,5.30973451327434,7.9646017699115,27.8761061946903,15.929203539823,42.9203539823009,15.4867256637168,7.07964601769912,15.4867256637168,4.86725663716814
"E00167079",175,4,7,123,41,106,2,2,72,30,69,2,5,51,11,2.28571428571429,4,70.2857142857143,23.4285714285714,60.5714285714286,1.14285714285714,1.14285714285714,41.1428571428571,17.1428571428571,39.4285714285714,1.14285714285714,2.85714285714286,29.1428571428571,6.28571428571429
"E00167080",169,12,32,102,23,98,2,18,61,17,71,10,14,41,6,7.10059171597633,18.9349112426036,60.3550295857988,13.6094674556213,57.9881656804734,1.18343195266272,10.6508875739645,36.094674556213,10.0591715976331,42.0118343195266,5.91715976331361,8.28402366863905,24.2603550295858,3.55029585798817
"E00167081",183,15,11,108,49,108,5,6,60,37,75,10,5,48,12,8.19672131147541,6.01092896174863,59.0163934426229,26.775956284153,59.0163934426229,2.73224043715847,3.27868852459016,32.7868852459016,20.2185792349727,40.9836065573771,5.46448087431694,2.73224043715847,26.2295081967213,6.55737704918033
"E00167082",185,8,15,125,37,113,2,9,73,29,72,6,6,52,8,4.32432432432432,8.10810810810811,67.5675675675676,20,61.0810810810811,1.08108108108108,4.86486486486486,39.4594594594595,15.6756756756757,38.9189189189189,3.24324324324324,3.24324324324324,28.1081081081081,4.32432432432432
"E00167083",144,14,17,87,26,91,7,13,49,22,53,7,4,38,4,9.72222222222222,11.8055555555556,60.4166666666667,18.0555555555556,63.1944444444444,4.86111111111111,9.02777777777778,34.0277777777778,15.2777777777778,36.8055555555556,4.86111111111111,2.77777777777778,26.3888888888889,2.77777777777778
"E00167084",153,9,21,100,23,83,6,8,52,17,70,3,13,48,6,5.88235294117647,13.7254901960784,65.359477124183,15.0326797385621,54.2483660130719,3.92156862745098,5.22875816993464,33.9869281045752,11.1111111111111,45.7516339869281,1.96078431372549,8.49673202614379,31.3725490196078,3.92156862745098
"E00167085",132,9,18,86,19,78,4,9,51,14,54,5,9,35,5,6.81818181818182,13.6363636363636,65.1515151515152,14.3939393939394,59.0909090909091,3.03030303030303,6.81818181818182,38.6363636363636,10.6060606060606,40.9090909090909,3.78787878787879,6.81818181818182,26.5151515151515,3.78787878787879
"E00167086",188,17,29,104,38,112,10,13,65,24,76,7,16,39,14,9.04255319148936,15.4255319148936,55.3191489361702,20.2127659574468,59.5744680851064,5.31914893617021,6.91489361702128,34.5744680851064,12.7659574468085,40.4255319148936,3.72340425531915,8.51063829787234,20.7446808510638,7.4468085106383
"E00167087",219,7,9,138,65,122,2,4,76,40,97,5,5,62,25,3.19634703196347,4.10958904109589,63.013698630137,29.6803652968037,55.7077625570776,0.91324200913242,1.82648401826484,34.703196347032,18.2648401826484,44.2922374429224,2.28310502283105,2.28310502283105,28.310502283105,11.4155251141553
"E00167088",157,10,10,89,48,78,1,6,45,26,79,9,4,44,22,6.36942675159236,6.36942675159236,56.687898089172,30.5732484076433,49.6815286624204,0.636942675159236,3.82165605095541,28.6624203821656,16.5605095541401,50.3184713375796,5.73248407643312,2.54777070063694,28.0254777070064,14.0127388535032
"E00167089",115,9,18,72,16,60,4,9,38,9,55,5,9,34,7,7.82608695652174,15.6521739130435,62.6086956521739,13.9130434782609,52.1739130434783,3.47826086956522,7.82608695652174,33.0434782608696,7.82608695652174,47.8260869565217,4.34782608695652,7.82608695652174,29.5652173913043,6.08695652173913
"E00167090",121,6,13,81,21,61,1,6,41,13,60,5,7,40,8,4.95867768595041,10.7438016528926,66.9421487603306,17.3553719008264,50.4132231404959,0.826446280991736,4.95867768595041,33.8842975206612,10.7438016528926,49.5867768595041,4.13223140495868,5.78512396694215,33.0578512396694,6.61157024793388
"E00167091",203,7,26,122,48,121,4,12,75,30,82,3,14,47,18,3.44827586206897,12.807881773399,60.0985221674877,23.6453201970443,59.6059113300493,1.97044334975369,5.91133004926108,36.9458128078818,14.7783251231527,40.3940886699507,1.47783251231527,6.89655172413793,23.1527093596059,8.86699507389163
"E00167092",174,9,25,101,39,98,1,12,61,24,76,8,13,40,15,5.17241379310345,14.367816091954,58.0459770114943,22.4137931034483,56.3218390804598,0.574712643678161,6.89655172413793,35.0574712643678,13.7931034482759,43.6781609195402,4.59770114942529,7.47126436781609,22.9885057471264,8.62068965517241
"E00167093",133,4,11,73,45,76,2,4,38,32,57,2,7,35,13,3.00751879699248,8.27067669172932,54.8872180451128,33.8345864661654,57.1428571428571,1.50375939849624,3.00751879699248,28.5714285714286,24.0601503759398,42.8571428571429,1.50375939849624,5.26315789473684,26.3157894736842,9.77443609022556
"E00167094",200,14,9,121,56,134,10,5,72,47,66,4,4,49,9,7,4.5,60.5,28,67,5,2.5,36,23.5,33,2,2,24.5,4.5
"E00167095",133,13,24,75,21,82,6,19,43,14,51,7,5,32,7,9.77443609022556,18.0451127819549,56.390977443609,15.7894736842105,61.6541353383459,4.51127819548872,14.2857142857143,32.3308270676692,10.5263157894737,38.3458646616541,5.26315789473684,3.7593984962406,24.0601503759398,5.26315789473684
"E00167096",105,8,7,56,34,67,8,0,33,26,38,0,7,23,8,7.61904761904762,6.66666666666667,53.3333333333333,32.3809523809524,63.8095238095238,7.61904761904762,0,31.4285714285714,24.7619047619048,36.1904761904762,0,6.66666666666667,21.9047619047619,7.61904761904762
"E00167097",163,8,10,84,61,93,2,7,44,40,70,6,3,40,21,4.9079754601227,6.13496932515337,51.5337423312883,37.4233128834356,57.0552147239264,1.22699386503067,4.29447852760736,26.9938650306748,24.5398773006135,42.9447852760736,3.68098159509202,1.84049079754601,24.5398773006135,12.8834355828221
"E00167098",117,2,4,49,62,77,1,3,28,45,40,1,1,21,17,1.70940170940171,3.41880341880342,41.8803418803419,52.991452991453,65.8119658119658,0.854700854700855,2.56410256410256,23.9316239316239,38.4615384615385,34.1880341880342,0.854700854700855,0.854700854700855,17.9487179487179,14.5299145299145
"E00167099",92,3,7,39,43,60,1,5,25,29,32,2,2,14,14,3.26086956521739,7.60869565217391,42.3913043478261,46.7391304347826,65.2173913043478,1.08695652173913,5.43478260869565,27.1739130434783,31.5217391304348,34.7826086956522,2.17391304347826,2.17391304347826,15.2173913043478,15.2173913043478
"E00167100",438,12,18,225,183,278,6,9,139,124,160,6,9,86,59,2.73972602739726,4.10958904109589,51.3698630136986,41.7808219178082,63.4703196347032,1.36986301369863,2.05479452054794,31.7351598173516,28.310502283105,36.5296803652968,1.36986301369863,2.05479452054794,19.634703196347,13.4703196347032
"E00167101",205,4,5,102,94,122,3,2,53,64,83,1,3,49,30,1.95121951219512,2.4390243902439,49.7560975609756,45.8536585365854,59.5121951219512,1.46341463414634,0.975609756097561,25.8536585365854,31.219512195122,40.4878048780488,0.48780487804878,1.46341463414634,23.9024390243902,14.6341463414634
"E00167102",156,17,33,68,38,102,9,23,42,28,54,8,10,26,10,10.8974358974359,21.1538461538462,43.5897435897436,24.3589743589744,65.3846153846154,5.76923076923077,14.7435897435897,26.9230769230769,17.9487179487179,34.6153846153846,5.12820512820513,6.41025641025641,16.6666666666667,6.41025641025641
"E00167103",179,3,5,99,72,107,2,2,51,52,72,1,3,48,20,1.67597765363128,2.79329608938547,55.3072625698324,40.2234636871508,59.7765363128492,1.11731843575419,1.11731843575419,28.4916201117318,29.0502793296089,40.2234636871508,0.558659217877095,1.67597765363128,26.8156424581006,11.1731843575419
"E00167104",179,3,7,90,79,104,2,3,47,52,75,1,4,43,27,1.67597765363128,3.91061452513966,50.2793296089386,44.1340782122905,58.1005586592179,1.11731843575419,1.67597765363128,26.2569832402235,29.0502793296089,41.8994413407821,0.558659217877095,2.23463687150838,24.0223463687151,15.0837988826816
"E00167105",142,16,42,73,11,88,4,30,44,10,54,12,12,29,1,11.2676056338028,29.5774647887324,51.4084507042254,7.74647887323944,61.9718309859155,2.8169014084507,21.1267605633803,30.9859154929577,7.04225352112676,38.0281690140845,8.45070422535211,8.45070422535211,20.4225352112676,0.704225352112676
"E00167106",232,13,8,129,82,140,8,6,77,49,92,5,2,52,33,5.60344827586207,3.44827586206897,55.6034482758621,35.3448275862069,60.3448275862069,3.44827586206897,2.58620689655172,33.1896551724138,21.1206896551724,39.6551724137931,2.1551724137931,0.862068965517241,22.4137931034483,14.2241379310345
"E00167107",136,3,17,68,48,84,0,9,42,33,52,3,8,26,15,2.20588235294118,12.5,50,35.2941176470588,61.7647058823529,0,6.61764705882353,30.8823529411765,24.2647058823529,38.2352941176471,2.20588235294118,5.88235294117647,19.1176470588235,11.0294117647059
"E00167108",170,13,28,105,24,88,6,11,55,16,82,7,17,50,8,7.64705882352941,16.4705882352941,61.7647058823529,14.1176470588235,51.7647058823529,3.52941176470588,6.47058823529412,32.3529411764706,9.41176470588235,48.2352941176471,4.11764705882353,10,29.4117647058824,4.70588235294118
"E00167109",152,7,11,87,47,92,3,4,52,33,60,4,7,35,14,4.60526315789474,7.23684210526316,57.2368421052632,30.9210526315789,60.5263157894737,1.97368421052632,2.63157894736842,34.2105263157895,21.7105263157895,39.4736842105263,2.63157894736842,4.60526315789474,23.0263157894737,9.21052631578947
"E00167110",161,9,14,95,43,98,4,9,55,30,63,5,5,40,13,5.59006211180124,8.69565217391304,59.0062111801242,26.7080745341615,60.8695652173913,2.48447204968944,5.59006211180124,34.1614906832298,18.6335403726708,39.1304347826087,3.1055900621118,3.1055900621118,24.8447204968944,8.07453416149068
"E00167111",218,9,10,127,72,131,2,4,75,50,87,7,6,52,22,4.12844036697248,4.58715596330275,58.2568807339449,33.0275229357798,60.091743119266,0.917431192660551,1.8348623853211,34.4036697247706,22.9357798165138,39.9082568807339,3.21100917431193,2.75229357798165,23.8532110091743,10.0917431192661
"E00167112",525,26,25,309,165,292,11,7,159,115,233,15,18,150,50,4.95238095238095,4.76190476190476,58.8571428571429,31.4285714285714,55.6190476190476,2.0952380952381,1.33333333333333,30.2857142857143,21.9047619047619,44.3809523809524,2.85714285714286,3.42857142857143,28.5714285714286,9.52380952380952
"E00167113",169,14,25,88,42,98,8,14,47,29,71,6,11,41,13,8.28402366863905,14.792899408284,52.0710059171598,24.8520710059172,57.9881656804734,4.73372781065089,8.28402366863905,27.810650887574,17.1597633136095,42.0118343195266,3.55029585798817,6.50887573964497,24.2603550295858,7.69230769230769
"E00167114",170,24,31,92,23,92,11,12,57,12,78,13,19,35,11,14.1176470588235,18.2352941176471,54.1176470588235,13.5294117647059,54.1176470588235,6.47058823529412,7.05882352941176,33.5294117647059,7.05882352941176,45.8823529411765,7.64705882352941,11.1764705882353,20.5882352941176,6.47058823529412
"E00167115",407,12,36,248,111,249,6,19,152,72,158,6,17,96,39,2.94840294840295,8.84520884520884,60.9336609336609,27.2727272727273,61.1793611793612,1.47420147420147,4.66830466830467,37.3464373464373,17.6904176904177,38.8206388206388,1.47420147420147,4.17690417690418,23.5872235872236,9.58230958230958
"E00167116",111,8,26,58,19,58,3,12,28,15,53,5,14,30,4,7.20720720720721,23.4234234234234,52.2522522522522,17.1171171171171,52.2522522522522,2.7027027027027,10.8108108108108,25.2252252252252,13.5135135135135,47.7477477477478,4.5045045045045,12.6126126126126,27.027027027027,3.6036036036036
"E00167117",92,2,2,65,23,57,0,0,38,19,35,2,2,27,4,2.17391304347826,2.17391304347826,70.6521739130435,25,61.9565217391304,0,0,41.304347826087,20.6521739130435,38.0434782608696,2.17391304347826,2.17391304347826,29.3478260869565,4.34782608695652
"E00167118",183,4,10,101,68,110,1,6,60,43,73,3,4,41,25,2.18579234972678,5.46448087431694,55.1912568306011,37.1584699453552,60.1092896174863,0.546448087431694,3.27868852459016,32.7868852459016,23.4972677595628,39.8907103825137,1.63934426229508,2.18579234972678,22.4043715846995,13.6612021857924
"E00167119",170,9,24,90,47,110,5,16,59,30,60,4,8,31,17,5.29411764705882,14.1176470588235,52.9411764705882,27.6470588235294,64.7058823529412,2.94117647058824,9.41176470588235,34.7058823529412,17.6470588235294,35.2941176470588,2.35294117647059,4.70588235294118,18.2352941176471,10
"E00167120",176,9,19,108,40,101,4,10,61,26,75,5,9,47,14,5.11363636363636,10.7954545454545,61.3636363636364,22.7272727272727,57.3863636363636,2.27272727272727,5.68181818181818,34.6590909090909,14.7727272727273,42.6136363636364,2.84090909090909,5.11363636363636,26.7045454545455,7.95454545454545
"E00167121",194,4,5,70,115,119,1,2,35,81,75,3,3,35,34,2.06185567010309,2.57731958762887,36.0824742268041,59.2783505154639,61.340206185567,0.515463917525773,1.03092783505155,18.0412371134021,41.7525773195876,38.659793814433,1.54639175257732,1.54639175257732,18.0412371134021,17.5257731958763
"E00167122",140,8,4,73,55,92,4,1,43,44,48,4,3,30,11,5.71428571428571,2.85714285714286,52.1428571428571,39.2857142857143,65.7142857142857,2.85714285714286,0.714285714285714,30.7142857142857,31.4285714285714,34.2857142857143,2.85714285714286,2.14285714285714,21.4285714285714,7.85714285714286
"E00167123",145,15,34,86,10,65,8,13,37,7,80,7,21,49,3,10.3448275862069,23.448275862069,59.3103448275862,6.89655172413793,44.8275862068966,5.51724137931035,8.96551724137931,25.5172413793103,4.82758620689655,55.1724137931034,4.82758620689655,14.4827586206897,33.7931034482759,2.06896551724138
"E00167124",178,13,19,101,45,93,9,10,48,26,85,4,9,53,19,7.30337078651685,10.6741573033708,56.7415730337079,25.2808988764045,52.247191011236,5.0561797752809,5.61797752808989,26.9662921348315,14.6067415730337,47.752808988764,2.24719101123596,5.0561797752809,29.7752808988764,10.6741573033708
"E00167125",118,1,3,80,34,72,0,0,51,21,46,1,3,29,13,0.847457627118644,2.54237288135593,67.7966101694915,28.8135593220339,61.0169491525424,0,0,43.2203389830509,17.7966101694915,38.9830508474576,0.847457627118644,2.54237288135593,24.5762711864407,11.0169491525424
"E00167126",264,7,17,165,75,160,4,11,89,56,104,3,6,76,19,2.65151515151515,6.43939393939394,62.5,28.4090909090909,60.6060606060606,1.51515151515152,4.16666666666667,33.7121212121212,21.2121212121212,39.3939393939394,1.13636363636364,2.27272727272727,28.7878787878788,7.1969696969697
"E00167127",174,9,8,102,55,105,2,5,59,39,69,7,3,43,16,5.17241379310345,4.59770114942529,58.6206896551724,31.6091954022989,60.3448275862069,1.14942528735632,2.8735632183908,33.9080459770115,22.4137931034483,39.6551724137931,4.02298850574713,1.72413793103448,24.7126436781609,9.19540229885057
"E00167128",94,8,26,47,13,55,3,15,28,9,39,5,11,19,4,8.51063829787234,27.6595744680851,50,13.8297872340426,58.5106382978723,3.19148936170213,15.9574468085106,29.7872340425532,9.57446808510638,41.4893617021277,5.31914893617021,11.7021276595745,20.2127659574468,4.25531914893617
"E00167129",392,14,30,200,148,220,2,10,112,96,172,12,20,88,52,3.57142857142857,7.6530612244898,51.0204081632653,37.7551020408163,56.1224489795918,0.510204081632653,2.55102040816327,28.5714285714286,24.4897959183673,43.8775510204082,3.06122448979592,5.10204081632653,22.4489795918367,13.265306122449
"E00167130",525,26,33,307,159,322,10,14,183,115,203,16,19,124,44,4.95238095238095,6.28571428571429,58.4761904761905,30.2857142857143,61.3333333333333,1.9047619047619,2.66666666666667,34.8571428571429,21.9047619047619,38.6666666666667,3.04761904761905,3.61904761904762,23.6190476190476,8.38095238095238
"E00167131",48,8,8,26,6,24,2,3,14,5,24,6,5,12,1,16.6666666666667,16.6666666666667,54.1666666666667,12.5,50,4.16666666666667,6.25,29.1666666666667,10.4166666666667,50,12.5,10.4166666666667,25,2.08333333333333
"E00167132",300,6,14,160,120,195,4,2,97,92,105,2,12,63,28,2,4.66666666666667,53.3333333333333,40,65,1.33333333333333,0.666666666666667,32.3333333333333,30.6666666666667,35,0.666666666666667,4,21,9.33333333333333
"E00167133",92,3,18,54,17,56,0,7,37,12,36,3,11,17,5,3.26086956521739,19.5652173913043,58.695652173913,18.4782608695652,60.8695652173913,0,7.60869565217391,40.2173913043478,13.0434782608696,39.1304347826087,3.26086956521739,11.9565217391304,18.4782608695652,5.43478260869565
"E00167134",180,10,6,113,51,102,3,1,58,40,78,7,5,55,11,5.55555555555556,3.33333333333333,62.7777777777778,28.3333333333333,56.6666666666667,1.66666666666667,0.555555555555556,32.2222222222222,22.2222222222222,43.3333333333333,3.88888888888889,2.77777777777778,30.5555555555556,6.11111111111111
"E00167135",196,4,5,113,74,119,2,1,61,55,77,2,4,52,19,2.04081632653061,2.55102040816327,57.6530612244898,37.7551020408163,60.7142857142857,1.02040816326531,0.510204081632653,31.1224489795918,28.0612244897959,39.2857142857143,1.02040816326531,2.04081632653061,26.530612244898,9.69387755102041
"E00167136",70,6,17,42,5,37,4,8,22,3,33,2,9,20,2,8.57142857142857,24.2857142857143,60,7.14285714285714,52.8571428571429,5.71428571428571,11.4285714285714,31.4285714285714,4.28571428571429,47.1428571428571,2.85714285714286,12.8571428571429,28.5714285714286,2.85714285714286
"E00167137",172,5,4,89,74,103,3,3,51,46,69,2,1,38,28,2.90697674418605,2.32558139534884,51.7441860465116,43.0232558139535,59.8837209302326,1.74418604651163,1.74418604651163,29.6511627906977,26.7441860465116,40.1162790697674,1.16279069767442,0.581395348837209,22.093023255814,16.2790697674419
"E00167138",139,3,14,80,42,80,1,4,46,29,59,2,10,34,13,2.15827338129496,10.0719424460432,57.5539568345324,30.2158273381295,57.5539568345324,0.719424460431655,2.87769784172662,33.0935251798561,20.863309352518,42.4460431654676,1.43884892086331,7.19424460431655,24.4604316546763,9.35251798561151
"E00167139",208,10,7,94,97,137,6,5,54,72,71,4,2,40,25,4.80769230769231,3.36538461538462,45.1923076923077,46.6346153846154,65.8653846153846,2.88461538461538,2.40384615384615,25.9615384615385,34.6153846153846,34.1346153846154,1.92307692307692,0.961538461538462,19.2307692307692,12.0192307692308
"E00167140",144,9,14,92,29,82,3,6,50,23,62,6,8,42,6,6.25,9.72222222222222,63.8888888888889,20.1388888888889,56.9444444444444,2.08333333333333,4.16666666666667,34.7222222222222,15.9722222222222,43.0555555555556,4.16666666666667,5.55555555555556,29.1666666666667,4.16666666666667
"E00167141",250,4,9,162,75,151,2,6,89,54,99,2,3,73,21,1.6,3.6,64.8,30,60.4,0.8,2.4,35.6,21.6,39.6,0.8,1.2,29.2,8.4
"E00167142",342,8,16,196,122,187,3,4,103,77,155,5,12,93,45,2.33918128654971,4.67836257309941,57.3099415204678,35.672514619883,54.6783625730994,0.87719298245614,1.16959064327485,30.1169590643275,22.5146198830409,45.3216374269006,1.46198830409357,3.50877192982456,27.1929824561404,13.1578947368421
"E00167143",150,17,27,92,14,90,7,16,57,10,60,10,11,35,4,11.3333333333333,18,61.3333333333333,9.33333333333333,60,4.66666666666667,10.6666666666667,38,6.66666666666667,40,6.66666666666667,7.33333333333333,23.3333333333333,2.66666666666667
"E00167144",118,16,34,59,9,70,6,23,35,6,48,10,11,24,3,13.5593220338983,28.8135593220339,50,7.6271186440678,59.3220338983051,5.08474576271187,19.4915254237288,29.6610169491525,5.08474576271187,40.6779661016949,8.47457627118644,9.32203389830508,20.3389830508475,2.54237288135593
"E00167145",146,6,10,76,54,92,3,5,42,42,54,3,5,34,12,4.10958904109589,6.84931506849315,52.0547945205479,36.986301369863,63.013698630137,2.05479452054794,3.42465753424658,28.7671232876712,28.7671232876712,36.986301369863,2.05479452054794,3.42465753424658,23.2876712328767,8.21917808219178
"E00167146",222,3,10,152,57,140,2,1,94,43,82,1,9,58,14,1.35135135135135,4.5045045045045,68.4684684684685,25.6756756756757,63.0630630630631,0.900900900900901,0.45045045045045,42.3423423423423,19.3693693693694,36.9369369369369,0.45045045045045,4.05405405405405,26.1261261261261,6.30630630630631
"E00167147",101,15,23,49,14,50,4,10,25,11,51,11,13,24,3,14.8514851485149,22.7722772277228,48.5148514851485,13.8613861386139,49.5049504950495,3.96039603960396,9.9009900990099,24.7524752475248,10.8910891089109,50.4950495049505,10.8910891089109,12.8712871287129,23.7623762376238,2.97029702970297
"E00167148",157,2,3,79,73,99,1,1,44,53,58,1,2,35,20,1.27388535031847,1.91082802547771,50.3184713375796,46.4968152866242,63.0573248407643,0.636942675159236,0.636942675159236,28.0254777070064,33.7579617834395,36.9426751592357,0.636942675159236,1.27388535031847,22.2929936305732,12.7388535031847
"E00167149",108,3,6,67,32,71,1,2,39,29,37,2,4,28,3,2.77777777777778,5.55555555555556,62.037037037037,29.6296296296296,65.7407407407407,0.925925925925926,1.85185185185185,36.1111111111111,26.8518518518519,34.2592592592593,1.85185185185185,3.7037037037037,25.9259259259259,2.77777777777778
"E00167150",276,8,23,190,55,173,3,8,128,34,103,5,15,62,21,2.89855072463768,8.33333333333333,68.8405797101449,19.9275362318841,62.6811594202899,1.08695652173913,2.89855072463768,46.3768115942029,12.3188405797101,37.3188405797101,1.81159420289855,5.43478260869565,22.463768115942,7.60869565217391
"E00167151",317,5,14,159,139,192,2,5,92,93,125,3,9,67,46,1.57728706624606,4.41640378548896,50.1577287066246,43.8485804416404,60.5678233438486,0.630914826498423,1.57728706624606,29.0220820189274,29.3375394321767,39.4321766561514,0.946372239747634,2.8391167192429,21.1356466876972,14.5110410094637
"E00167152",121,0,3,68,50,77,0,2,35,40,44,0,1,33,10,0,2.47933884297521,56.198347107438,41.3223140495868,63.6363636363636,0,1.65289256198347,28.9256198347107,33.0578512396694,36.3636363636364,0,0.826446280991736,27.2727272727273,8.26446280991736
"E00167153",115,14,26,47,28,72,5,13,30,24,43,9,13,17,4,12.1739130434783,22.6086956521739,40.8695652173913,24.3478260869565,62.6086956521739,4.34782608695652,11.304347826087,26.0869565217391,20.8695652173913,37.3913043478261,7.82608695652174,11.304347826087,14.7826086956522,3.47826086956522
"E00167154",166,3,12,99,52,96,1,4,61,30,70,2,8,38,22,1.80722891566265,7.2289156626506,59.6385542168675,31.3253012048193,57.8313253012048,0.602409638554217,2.40963855421687,36.7469879518072,18.0722891566265,42.1686746987952,1.20481927710843,4.81927710843374,22.8915662650602,13.2530120481928
"E00167155",224,13,12,134,65,144,6,6,83,49,80,7,6,51,16,5.80357142857143,5.35714285714286,59.8214285714286,29.0178571428571,64.2857142857143,2.67857142857143,2.67857142857143,37.0535714285714,21.875,35.7142857142857,3.125,2.67857142857143,22.7678571428571,7.14285714285714
"E00167156",111,9,30,62,10,67,4,19,37,7,44,5,11,25,3,8.10810810810811,27.027027027027,55.8558558558559,9.00900900900901,60.3603603603604,3.6036036036036,17.1171171171171,33.3333333333333,6.30630630630631,39.6396396396396,4.5045045045045,9.90990990990991,22.5225225225225,2.7027027027027
"E00167157",272,10,8,133,121,162,4,2,68,88,110,6,6,65,33,3.67647058823529,2.94117647058824,48.8970588235294,44.4852941176471,59.5588235294118,1.47058823529412,0.735294117647059,25,32.3529411764706,40.4411764705882,2.20588235294118,2.20588235294118,23.8970588235294,12.1323529411765
"E00167158",201,6,7,83,105,147,2,3,49,93,54,4,4,34,12,2.98507462686567,3.48258706467662,41.2935323383085,52.2388059701493,73.134328358209,0.995024875621891,1.49253731343284,24.3781094527363,46.2686567164179,26.865671641791,1.99004975124378,1.99004975124378,16.9154228855721,5.97014925373134
"E00167159",165,10,9,70,76,101,7,5,40,49,64,3,4,30,27,6.06060606060606,5.45454545454545,42.4242424242424,46.0606060606061,61.2121212121212,4.24242424242424,3.03030303030303,24.2424242424242,29.6969696969697,38.7878787878788,1.81818181818182,2.42424242424242,18.1818181818182,16.3636363636364
"E00167160",145,11,30,76,28,77,4,17,34,22,68,7,13,42,6,7.58620689655172,20.6896551724138,52.4137931034483,19.3103448275862,53.1034482758621,2.75862068965517,11.7241379310345,23.448275862069,15.1724137931034,46.8965517241379,4.82758620689655,8.96551724137931,28.9655172413793,4.13793103448276
"E00167161",99,7,16,67,9,56,3,8,37,8,43,4,8,30,1,7.07070707070707,16.1616161616162,67.6767676767677,9.09090909090909,56.5656565656566,3.03030303030303,8.08080808080808,37.3737373737374,8.08080808080808,43.4343434343434,4.04040404040404,8.08080808080808,30.3030303030303,1.01010101010101
"E00167162",255,7,8,164,76,158,3,5,96,54,97,4,3,68,22,2.74509803921569,3.13725490196078,64.3137254901961,29.8039215686275,61.9607843137255,1.17647058823529,1.96078431372549,37.6470588235294,21.1764705882353,38.0392156862745,1.56862745098039,1.17647058823529,26.6666666666667,8.62745098039216
"E00167163",205,12,14,146,33,102,3,4,74,21,103,9,10,72,12,5.85365853658537,6.82926829268293,71.219512195122,16.0975609756098,49.7560975609756,1.46341463414634,1.95121951219512,36.0975609756098,10.2439024390244,50.2439024390244,4.39024390243902,4.8780487804878,35.1219512195122,5.85365853658537
"E00167164",58,2,10,37,9,31,1,1,23,6,27,1,9,14,3,3.44827586206897,17.2413793103448,63.7931034482759,15.5172413793103,53.448275862069,1.72413793103448,1.72413793103448,39.6551724137931,10.3448275862069,46.551724137931,1.72413793103448,15.5172413793103,24.1379310344828,5.17241379310345
"E00167165",202,4,8,122,68,124,2,3,70,49,78,2,5,52,19,1.98019801980198,3.96039603960396,60.3960396039604,33.6633663366337,61.3861386138614,0.99009900990099,1.48514851485149,34.6534653465347,24.2574257425743,38.6138613861386,0.99009900990099,2.47524752475248,25.7425742574257,9.40594059405941
"E00167166",342,13,20,232,77,210,5,13,145,47,132,8,7,87,30,3.80116959064327,5.84795321637427,67.8362573099415,22.5146198830409,61.4035087719298,1.46198830409357,3.80116959064327,42.3976608187134,13.7426900584795,38.5964912280702,2.33918128654971,2.04678362573099,25.4385964912281,8.7719298245614
"E00167167",226,8,15,137,66,140,6,7,78,49,86,2,8,59,17,3.53982300884956,6.63716814159292,60.6194690265487,29.2035398230088,61.9469026548673,2.65486725663717,3.09734513274336,34.5132743362832,21.6814159292035,38.0530973451327,0.884955752212389,3.53982300884956,26.1061946902655,7.52212389380531
"E00167168",190,7,9,104,70,128,2,7,70,49,62,5,2,34,21,3.68421052631579,4.73684210526316,54.7368421052632,36.8421052631579,67.3684210526316,1.05263157894737,3.68421052631579,36.8421052631579,25.7894736842105,32.6315789473684,2.63157894736842,1.05263157894737,17.8947368421053,11.0526315789474
"E00167169",139,18,22,76,23,75,8,9,37,21,64,10,13,39,2,12.9496402877698,15.8273381294964,54.6762589928058,16.5467625899281,53.9568345323741,5.75539568345324,6.47482014388489,26.6187050359712,15.1079136690647,46.0431654676259,7.19424460431655,9.35251798561151,28.0575539568345,1.43884892086331
"E00167170",123,6,5,62,50,76,3,3,33,37,47,3,2,29,13,4.8780487804878,4.0650406504065,50.4065040650407,40.650406504065,61.7886178861789,2.4390243902439,2.4390243902439,26.8292682926829,30.0813008130081,38.2113821138211,2.4390243902439,1.6260162601626,23.5772357723577,10.5691056910569
"E00167171",78,15,27,31,5,53,8,20,21,4,25,7,7,10,1,19.2307692307692,34.6153846153846,39.7435897435897,6.41025641025641,67.948717948718,10.2564102564103,25.6410256410256,26.9230769230769,5.12820512820513,32.0512820512821,8.97435897435897,8.97435897435897,12.8205128205128,1.28205128205128
"E00167172",151,6,20,98,27,75,5,8,47,15,76,1,12,51,12,3.97350993377483,13.2450331125828,64.9006622516556,17.8807947019868,49.6688741721854,3.3112582781457,5.29801324503311,31.1258278145695,9.93377483443709,50.3311258278146,0.662251655629139,7.94701986754967,33.7748344370861,7.94701986754967
"E00167173",147,10,57,69,11,98,6,45,41,6,49,4,12,28,5,6.80272108843537,38.7755102040816,46.9387755102041,7.48299319727891,66.6666666666667,4.08163265306122,30.6122448979592,27.891156462585,4.08163265306122,33.3333333333333,2.72108843537415,8.16326530612245,19.047619047619,3.40136054421769
"E00167174",182,7,14,86,75,110,4,4,47,55,72,3,10,39,20,3.84615384615385,7.69230769230769,47.2527472527472,41.2087912087912,60.4395604395604,2.1978021978022,2.1978021978022,25.8241758241758,30.2197802197802,39.5604395604396,1.64835164835165,5.49450549450549,21.4285714285714,10.989010989011
"E00167175",142,3,13,56,70,89,3,4,33,49,53,0,9,23,21,2.11267605633803,9.15492957746479,39.4366197183099,49.2957746478873,62.6760563380282,2.11267605633803,2.8169014084507,23.2394366197183,34.5070422535211,37.3239436619718,0,6.33802816901408,16.1971830985916,14.7887323943662
"E00167176",230,19,28,132,51,123,10,17,64,32,107,9,11,68,19,8.26086956521739,12.1739130434783,57.3913043478261,22.1739130434783,53.4782608695652,4.34782608695652,7.39130434782609,27.8260869565217,13.9130434782609,46.5217391304348,3.91304347826087,4.78260869565217,29.5652173913043,8.26086956521739
"E00167177",208,4,19,117,68,122,3,9,64,46,86,1,10,53,22,1.92307692307692,9.13461538461538,56.25,32.6923076923077,58.6538461538462,1.44230769230769,4.32692307692308,30.7692307692308,22.1153846153846,41.3461538461538,0.480769230769231,4.80769230769231,25.4807692307692,10.5769230769231
"E00167178",177,10,20,97,50,107,6,10,55,36,70,4,10,42,14,5.64971751412429,11.2994350282486,54.8022598870056,28.2485875706215,60.4519774011299,3.38983050847458,5.64971751412429,31.0734463276836,20.3389830508475,39.5480225988701,2.25988700564972,5.64971751412429,23.728813559322,7.90960451977401
"E00167179",192,11,25,112,44,106,5,9,63,29,86,6,16,49,15,5.72916666666667,13.0208333333333,58.3333333333333,22.9166666666667,55.2083333333333,2.60416666666667,4.6875,32.8125,15.1041666666667,44.7916666666667,3.125,8.33333333333333,25.5208333333333,7.8125
"E00167180",130,13,23,79,15,72,3,11,47,11,58,10,12,32,4,10,17.6923076923077,60.7692307692308,11.5384615384615,55.3846153846154,2.30769230769231,8.46153846153846,36.1538461538462,8.46153846153846,44.6153846153846,7.69230769230769,9.23076923076923,24.6153846153846,3.07692307692308
"E00167181",94,6,14,55,19,63,4,4,38,17,31,2,10,17,2,6.38297872340426,14.8936170212766,58.5106382978723,20.2127659574468,67.0212765957447,4.25531914893617,4.25531914893617,40.4255319148936,18.0851063829787,32.9787234042553,2.12765957446809,10.6382978723404,18.0851063829787,2.12765957446809
"E00167182",53,10,9,22,12,27,3,5,8,11,26,7,4,14,1,18.8679245283019,16.9811320754717,41.5094339622642,22.6415094339623,50.9433962264151,5.66037735849057,9.43396226415094,15.0943396226415,20.7547169811321,49.0566037735849,13.2075471698113,7.54716981132075,26.4150943396226,1.88679245283019
"E00167183",105,4,1,57,43,57,0,0,28,29,48,4,1,29,14,3.80952380952381,0.952380952380952,54.2857142857143,40.9523809523809,54.2857142857143,0,0,26.6666666666667,27.6190476190476,45.7142857142857,3.80952380952381,0.952380952380952,27.6190476190476,13.3333333333333
"E00167184",100,10,11,60,19,55,8,4,30,13,45,2,7,30,6,10,11,60,19,55,8,4,30,13,45,2,7,30,6
"E00167185",88,9,22,50,7,54,5,6,37,6,34,4,16,13,1,10.2272727272727,25,56.8181818181818,7.95454545454545,61.3636363636364,5.68181818181818,6.81818181818182,42.0454545454545,6.81818181818182,38.6363636363636,4.54545454545455,18.1818181818182,14.7727272727273,1.13636363636364
"E00167186",190,10,14,113,53,103,7,7,55,34,87,3,7,58,19,5.26315789473684,7.36842105263158,59.4736842105263,27.8947368421053,54.2105263157895,3.68421052631579,3.68421052631579,28.9473684210526,17.8947368421053,45.7894736842105,1.57894736842105,3.68421052631579,30.5263157894737,10
"E00167187",166,19,12,110,25,88,5,5,64,14,78,14,7,46,11,11.4457831325301,7.2289156626506,66.2650602409639,15.0602409638554,53.0120481927711,3.01204819277108,3.01204819277108,38.5542168674699,8.43373493975904,46.9879518072289,8.43373493975904,4.21686746987952,27.710843373494,6.62650602409639
"E00167188",249,12,12,161,64,144,3,7,94,40,105,9,5,67,24,4.81927710843374,4.81927710843374,64.6586345381526,25.7028112449799,57.8313253012048,1.20481927710843,2.81124497991968,37.7510040160643,16.0642570281125,42.1686746987952,3.6144578313253,2.00803212851406,26.9076305220884,9.63855421686747
"E00167189",169,18,16,95,40,99,9,6,55,29,70,9,10,40,11,10.6508875739645,9.46745562130178,56.2130177514793,23.6686390532544,58.5798816568047,5.32544378698225,3.55029585798817,32.5443786982249,17.1597633136095,41.4201183431953,5.32544378698225,5.91715976331361,23.6686390532544,6.50887573964497
"E00167190",140,8,14,84,34,84,4,7,48,25,56,4,7,36,9,5.71428571428571,10,60,24.2857142857143,60,2.85714285714286,5,34.2857142857143,17.8571428571429,40,2.85714285714286,5,25.7142857142857,6.42857142857143
"E00167191",189,5,6,137,41,110,2,2,76,30,79,3,4,61,11,2.64550264550265,3.17460317460317,72.4867724867725,21.6931216931217,58.2010582010582,1.05820105820106,1.05820105820106,40.2116402116402,15.8730158730159,41.7989417989418,1.58730158730159,2.11640211640212,32.2751322751323,5.82010582010582
"E00167192",157,12,13,102,30,76,9,8,45,14,81,3,5,57,16,7.64331210191083,8.28025477707006,64.968152866242,19.1082802547771,48.4076433121019,5.73248407643312,5.09554140127389,28.6624203821656,8.9171974522293,51.5923566878981,1.91082802547771,3.18471337579618,36.3057324840764,10.1910828025478
"E00167193",83,10,17,48,8,39,3,5,24,7,44,7,12,24,1,12.0481927710843,20.4819277108434,57.8313253012048,9.63855421686747,46.9879518072289,3.6144578313253,6.02409638554217,28.9156626506024,8.43373493975904,53.0120481927711,8.43373493975904,14.4578313253012,28.9156626506024,1.20481927710843
"E00167194",149,10,10,101,28,83,2,6,57,18,66,8,4,44,10,6.71140939597315,6.71140939597315,67.7852348993289,18.7919463087248,55.7046979865772,1.34228187919463,4.02684563758389,38.255033557047,12.0805369127517,44.2953020134228,5.36912751677852,2.68456375838926,29.5302013422819,6.71140939597315
"E00167195",127,3,14,81,29,71,0,7,49,15,56,3,7,32,14,2.36220472440945,11.0236220472441,63.7795275590551,22.8346456692913,55.9055118110236,0,5.51181102362205,38.5826771653543,11.8110236220472,44.0944881889764,2.36220472440945,5.51181102362205,25.1968503937008,11.0236220472441
"E00167196",69,6,11,45,7,42,3,7,27,5,27,3,4,18,2,8.69565217391304,15.9420289855072,65.2173913043478,10.1449275362319,60.8695652173913,4.34782608695652,10.1449275362319,39.1304347826087,7.2463768115942,39.1304347826087,4.34782608695652,5.79710144927536,26.0869565217391,2.89855072463768
"E00167197",119,7,21,76,15,53,1,6,36,10,66,6,15,40,5,5.88235294117647,17.6470588235294,63.8655462184874,12.6050420168067,44.5378151260504,0.840336134453782,5.04201680672269,30.2521008403361,8.40336134453782,55.4621848739496,5.04201680672269,12.6050420168067,33.6134453781513,4.20168067226891
"E00167198",205,27,42,114,22,114,10,24,69,11,91,17,18,45,11,13.1707317073171,20.4878048780488,55.609756097561,10.7317073170732,55.609756097561,4.8780487804878,11.7073170731707,33.6585365853659,5.36585365853659,44.390243902439,8.29268292682927,8.78048780487805,21.9512195121951,5.36585365853659
"E00167199",124,5,11,86,22,80,3,7,54,16,44,2,4,32,6,4.03225806451613,8.87096774193548,69.3548387096774,17.741935483871,64.5161290322581,2.41935483870968,5.64516129032258,43.5483870967742,12.9032258064516,35.4838709677419,1.61290322580645,3.2258064516129,25.8064516129032,4.83870967741935
"E00167200",166,4,23,95,44,103,1,11,62,29,63,3,12,33,15,2.40963855421687,13.855421686747,57.2289156626506,26.5060240963855,62.0481927710843,0.602409638554217,6.62650602409639,37.3493975903614,17.4698795180723,37.9518072289157,1.80722891566265,7.2289156626506,19.8795180722892,9.03614457831325
"E00167201",104,7,28,61,8,52,3,9,34,6,52,4,19,27,2,6.73076923076923,26.9230769230769,58.6538461538462,7.69230769230769,50,2.88461538461538,8.65384615384615,32.6923076923077,5.76923076923077,50,3.84615384615385,18.2692307692308,25.9615384615385,1.92307692307692
"E00167202",67,6,16,34,11,38,4,8,19,7,29,2,8,15,4,8.95522388059701,23.8805970149254,50.7462686567164,16.4179104477612,56.7164179104478,5.97014925373134,11.9402985074627,28.3582089552239,10.4477611940298,43.2835820895522,2.98507462686567,11.9402985074627,22.3880597014925,5.97014925373134
"E00167203",182,12,30,88,52,112,6,20,48,38,70,6,10,40,14,6.59340659340659,16.4835164835165,48.3516483516484,28.5714285714286,61.5384615384615,3.2967032967033,10.989010989011,26.3736263736264,20.8791208791209,38.4615384615385,3.2967032967033,5.49450549450549,21.978021978022,7.69230769230769
"E00167204",201,7,6,128,60,113,0,2,68,43,88,7,4,60,17,3.48258706467662,2.98507462686567,63.681592039801,29.8507462686567,56.2189054726368,0,0.995024875621891,33.8308457711443,21.3930348258706,43.7810945273632,3.48258706467662,1.99004975124378,29.8507462686567,8.45771144278607
"E00167205",107,7,28,59,13,60,1,17,33,9,47,6,11,26,4,6.54205607476635,26.1682242990654,55.1401869158878,12.1495327102804,56.0747663551402,0.934579439252336,15.8878504672897,30.8411214953271,8.41121495327103,43.9252336448598,5.60747663551402,10.2803738317757,24.2990654205607,3.73831775700935
"E00167206",146,14,52,67,13,76,3,25,39,9,70,11,27,28,4,9.58904109589041,35.6164383561644,45.8904109589041,8.9041095890411,52.0547945205479,2.05479452054794,17.1232876712329,26.7123287671233,6.16438356164384,47.945205479452,7.53424657534247,18.4931506849315,19.1780821917808,2.73972602739726
"E00167207",159,9,22,95,33,93,4,14,52,23,66,5,8,43,10,5.66037735849057,13.8364779874214,59.748427672956,20.7547169811321,58.4905660377358,2.51572327044025,8.80503144654088,32.7044025157233,14.4654088050314,41.5094339622642,3.14465408805031,5.0314465408805,27.0440251572327,6.28930817610063
"E00167208",218,5,14,150,49,129,0,8,88,33,89,5,6,62,16,2.29357798165138,6.42201834862385,68.8073394495413,22.4770642201835,59.1743119266055,0,3.6697247706422,40.3669724770642,15.1376146788991,40.8256880733945,2.29357798165138,2.75229357798165,28.4403669724771,7.3394495412844
"E00167209",219,8,25,148,38,114,2,9,79,24,105,6,16,69,14,3.65296803652968,11.4155251141553,67.5799086757991,17.351598173516,52.0547945205479,0.91324200913242,4.10958904109589,36.0730593607306,10.958904109589,47.945205479452,2.73972602739726,7.30593607305936,31.5068493150685,6.39269406392694
"E00167210",106,0,7,65,34,65,0,5,35,25,41,0,2,30,9,0,6.60377358490566,61.3207547169811,32.0754716981132,61.3207547169811,0,4.71698113207547,33.0188679245283,23.5849056603774,38.6792452830189,0,1.88679245283019,28.3018867924528,8.49056603773585
"E00167211",147,18,39,75,15,81,6,24,40,11,66,12,15,35,4,12.2448979591837,26.530612244898,51.0204081632653,10.2040816326531,55.1020408163265,4.08163265306122,16.3265306122449,27.2108843537415,7.48299319727891,44.8979591836735,8.16326530612245,10.2040816326531,23.8095238095238,2.72108843537415
"E00167212",102,10,34,52,6,59,5,23,26,5,43,5,11,26,1,9.80392156862745,33.3333333333333,50.9803921568627,5.88235294117647,57.843137254902,4.90196078431373,22.5490196078431,25.4901960784314,4.90196078431373,42.156862745098,4.90196078431373,10.7843137254902,25.4901960784314,0.980392156862745
"E00167213",107,18,34,48,7,81,16,25,34,6,26,2,9,14,1,16.8224299065421,31.7757009345794,44.8598130841121,6.54205607476635,75.7009345794392,14.9532710280374,23.3644859813084,31.7757009345794,5.60747663551402,24.2990654205607,1.86915887850467,8.41121495327103,13.0841121495327,0.934579439252336
"E00167214",162,9,36,105,12,88,4,19,56,9,74,5,17,49,3,5.55555555555556,22.2222222222222,64.8148148148148,7.40740740740741,54.320987654321,2.46913580246914,11.7283950617284,34.5679012345679,5.55555555555556,45.679012345679,3.08641975308642,10.4938271604938,30.2469135802469,1.85185185185185
"E00167215",180,4,31,125,20,109,2,18,73,16,71,2,13,52,4,2.22222222222222,17.2222222222222,69.4444444444444,11.1111111111111,60.5555555555556,1.11111111111111,10,40.5555555555556,8.88888888888889,39.4444444444444,1.11111111111111,7.22222222222222,28.8888888888889,2.22222222222222
"E00167216",96,6,26,52,12,58,3,16,31,8,38,3,10,21,4,6.25,27.0833333333333,54.1666666666667,12.5,60.4166666666667,3.125,16.6666666666667,32.2916666666667,8.33333333333333,39.5833333333333,3.125,10.4166666666667,21.875,4.16666666666667
"E00167217",91,7,27,52,5,62,4,20,34,4,29,3,7,18,1,7.69230769230769,29.6703296703297,57.1428571428571,5.49450549450549,68.1318681318681,4.3956043956044,21.978021978022,37.3626373626374,4.3956043956044,31.8681318681319,3.2967032967033,7.69230769230769,19.7802197802198,1.0989010989011
"E00167218",158,6,20,108,24,82,1,8,57,16,76,5,12,51,8,3.79746835443038,12.6582278481013,68.3544303797468,15.1898734177215,51.8987341772152,0.632911392405063,5.06329113924051,36.0759493670886,10.126582278481,48.1012658227848,3.16455696202532,7.59493670886076,32.2784810126582,5.06329113924051
"E00167219",79,10,22,36,11,45,2,16,19,8,34,8,6,17,3,12.6582278481013,27.8481012658228,45.5696202531646,13.9240506329114,56.9620253164557,2.53164556962025,20.253164556962,24.0506329113924,10.126582278481,43.0379746835443,10.126582278481,7.59493670886076,21.5189873417722,3.79746835443038
"E00167220",188,7,11,113,57,111,4,1,65,41,77,3,10,48,16,3.72340425531915,5.85106382978723,60.1063829787234,30.3191489361702,59.0425531914894,2.12765957446809,0.531914893617021,34.5744680851064,21.8085106382979,40.9574468085106,1.59574468085106,5.31914893617021,25.531914893617,8.51063829787234
"E00167221",171,15,39,86,31,107,10,22,51,24,64,5,17,35,7,8.7719298245614,22.8070175438596,50.2923976608187,18.1286549707602,62.5730994152047,5.84795321637427,12.8654970760234,29.8245614035088,14.0350877192982,37.4269005847953,2.92397660818713,9.94152046783626,20.4678362573099,4.09356725146199
"E00167222",108,10,35,54,9,71,6,24,35,6,37,4,11,19,3,9.25925925925926,32.4074074074074,50,8.33333333333333,65.7407407407407,5.55555555555556,22.2222222222222,32.4074074074074,5.55555555555556,34.2592592592593,3.7037037037037,10.1851851851852,17.5925925925926,2.77777777777778
"E00167223",144,16,32,80,16,76,6,16,45,9,68,10,16,35,7,11.1111111111111,22.2222222222222,55.5555555555556,11.1111111111111,52.7777777777778,4.16666666666667,11.1111111111111,31.25,6.25,47.2222222222222,6.94444444444444,11.1111111111111,24.3055555555556,4.86111111111111
"E00167224",117,7,30,60,20,73,4,18,33,18,44,3,12,27,2,5.98290598290598,25.6410256410256,51.2820512820513,17.0940170940171,62.3931623931624,3.41880341880342,15.3846153846154,28.2051282051282,15.3846153846154,37.6068376068376,2.56410256410256,10.2564102564103,23.0769230769231,1.70940170940171
"E00167225",102,11,36,47,8,65,6,20,33,6,37,5,16,14,2,10.7843137254902,35.2941176470588,46.078431372549,7.84313725490196,63.7254901960784,5.88235294117647,19.6078431372549,32.3529411764706,5.88235294117647,36.2745098039216,4.90196078431373,15.6862745098039,13.7254901960784,1.96078431372549
"E00167226",184,4,11,136,33,105,3,5,72,25,79,1,6,64,8,2.17391304347826,5.97826086956522,73.9130434782609,17.9347826086957,57.0652173913043,1.6304347826087,2.71739130434783,39.1304347826087,13.5869565217391,42.9347826086957,0.543478260869565,3.26086956521739,34.7826086956522,4.34782608695652
"E00167227",165,11,28,91,35,100,5,14,56,25,65,6,14,35,10,6.66666666666667,16.969696969697,55.1515151515151,21.2121212121212,60.6060606060606,3.03030303030303,8.48484848484849,33.9393939393939,15.1515151515152,39.3939393939394,3.63636363636364,8.48484848484849,21.2121212121212,6.06060606060606
"E00167228",139,14,29,80,16,68,4,11,41,12,71,10,18,39,4,10.0719424460432,20.863309352518,57.5539568345324,11.5107913669065,48.9208633093525,2.87769784172662,7.9136690647482,29.4964028776978,8.63309352517986,51.0791366906475,7.19424460431655,12.9496402877698,28.0575539568345,2.87769784172662
"E00167229",111,5,31,63,12,71,2,19,40,10,40,3,12,23,2,4.5045045045045,27.9279279279279,56.7567567567568,10.8108108108108,63.963963963964,1.8018018018018,17.1171171171171,36.036036036036,9.00900900900901,36.036036036036,2.7027027027027,10.8108108108108,20.7207207207207,1.8018018018018
"E00167230",163,3,11,98,51,94,1,4,65,24,69,2,7,33,27,1.84049079754601,6.74846625766871,60.1226993865031,31.2883435582822,57.6687116564417,0.613496932515337,2.45398773006135,39.8773006134969,14.7239263803681,42.3312883435583,1.22699386503067,4.29447852760736,20.2453987730061,16.5644171779141
"E00167231",117,11,14,72,20,77,6,10,46,15,40,5,4,26,5,9.4017094017094,11.965811965812,61.5384615384615,17.0940170940171,65.8119658119658,5.12820512820513,8.54700854700855,39.3162393162393,12.8205128205128,34.1880341880342,4.27350427350427,3.41880341880342,22.2222222222222,4.27350427350427
"E00167232",141,10,11,89,31,90,5,3,60,22,51,5,8,29,9,7.09219858156028,7.80141843971631,63.1205673758865,21.9858156028369,63.8297872340426,3.54609929078014,2.12765957446809,42.5531914893617,15.6028368794326,36.1702127659575,3.54609929078014,5.67375886524823,20.5673758865248,6.38297872340426
"E00167233",118,4,19,79,16,66,1,6,48,11,52,3,13,31,5,3.38983050847458,16.1016949152542,66.9491525423729,13.5593220338983,55.9322033898305,0.847457627118644,5.08474576271187,40.6779661016949,9.32203389830508,44.0677966101695,2.54237288135593,11.0169491525424,26.271186440678,4.23728813559322
"E00167234",127,9,32,75,11,74,4,20,41,9,53,5,12,34,2,7.08661417322835,25.1968503937008,59.0551181102362,8.66141732283465,58.2677165354331,3.1496062992126,15.748031496063,32.2834645669291,7.08661417322835,41.7322834645669,3.93700787401575,9.44881889763779,26.7716535433071,1.5748031496063
"E00167235",146,24,46,68,8,93,12,31,42,8,53,12,15,26,0,16.4383561643836,31.5068493150685,46.5753424657534,5.47945205479452,63.6986301369863,8.21917808219178,21.2328767123288,28.7671232876712,5.47945205479452,36.3013698630137,8.21917808219178,10.2739726027397,17.8082191780822,0
"E00167236",148,7,6,68,67,91,5,2,36,48,57,2,4,32,19,4.72972972972973,4.05405405405405,45.945945945946,45.2702702702703,61.4864864864865,3.37837837837838,1.35135135135135,24.3243243243243,32.4324324324324,38.5135135135135,1.35135135135135,2.7027027027027,21.6216216216216,12.8378378378378
"E00167237",150,8,3,78,61,88,2,2,43,41,62,6,1,35,20,5.33333333333333,2,52,40.6666666666667,58.6666666666667,1.33333333333333,1.33333333333333,28.6666666666667,27.3333333333333,41.3333333333333,4,0.666666666666667,23.3333333333333,13.3333333333333
"E00167238",129,13,33,68,15,76,8,19,37,12,53,5,14,31,3,10.077519379845,25.5813953488372,52.7131782945737,11.6279069767442,58.9147286821705,6.2015503875969,14.7286821705426,28.6821705426357,9.30232558139535,41.0852713178295,3.87596899224806,10.8527131782946,24.031007751938,2.32558139534884
"E00167239",70,3,12,47,8,36,2,6,23,5,34,1,6,24,3,4.28571428571429,17.1428571428571,67.1428571428571,11.4285714285714,51.4285714285714,2.85714285714286,8.57142857142857,32.8571428571429,7.14285714285714,48.5714285714286,1.42857142857143,8.57142857142857,34.2857142857143,4.28571428571429
"E00167240",124,17,38,63,6,70,5,22,38,5,54,12,16,25,1,13.7096774193548,30.6451612903226,50.8064516129032,4.83870967741935,56.4516129032258,4.03225806451613,17.741935483871,30.6451612903226,4.03225806451613,43.5483870967742,9.67741935483871,12.9032258064516,20.1612903225806,0.806451612903226
"E00167241",111,14,45,44,8,78,12,33,28,5,33,2,12,16,3,12.6126126126126,40.5405405405405,39.6396396396396,7.20720720720721,70.2702702702703,10.8108108108108,29.7297297297297,25.2252252252252,4.5045045045045,29.7297297297297,1.8018018018018,10.8108108108108,14.4144144144144,2.7027027027027
"E00167242",115,10,26,64,15,66,7,11,35,13,49,3,15,29,2,8.69565217391304,22.6086956521739,55.6521739130435,13.0434782608696,57.3913043478261,6.08695652173913,9.56521739130435,30.4347826086957,11.304347826087,42.6086956521739,2.60869565217391,13.0434782608696,25.2173913043478,1.73913043478261
"E00167243",230,22,22,129,57,124,13,14,68,29,106,9,8,61,28,9.56521739130435,9.56521739130435,56.0869565217391,24.7826086956522,53.9130434782609,5.65217391304348,6.08695652173913,29.5652173913043,12.6086956521739,46.0869565217391,3.91304347826087,3.47826086956522,26.5217391304348,12.1739130434783
"E00167244",195,13,20,121,41,99,7,11,58,23,96,6,9,63,18,6.66666666666667,10.2564102564103,62.0512820512821,21.025641025641,50.7692307692308,3.58974358974359,5.64102564102564,29.7435897435897,11.7948717948718,49.2307692307692,3.07692307692308,4.61538461538462,32.3076923076923,9.23076923076923
"E00167245",173,15,26,100,32,100,8,10,60,22,73,7,16,40,10,8.67052023121387,15.028901734104,57.8034682080925,18.4971098265896,57.8034682080925,4.6242774566474,5.78034682080925,34.6820809248555,12.7167630057803,42.1965317919075,4.04624277456647,9.2485549132948,23.121387283237,5.78034682080925
"E00167246",77,6,10,51,10,40,1,4,29,6,37,5,6,22,4,7.79220779220779,12.987012987013,66.2337662337662,12.987012987013,51.9480519480519,1.2987012987013,5.19480519480519,37.6623376623377,7.79220779220779,48.0519480519481,6.49350649350649,7.79220779220779,28.5714285714286,5.19480519480519
"E00167247",113,7,6,74,26,60,3,1,42,14,53,4,5,32,12,6.19469026548673,5.30973451327434,65.4867256637168,23.0088495575221,53.0973451327434,2.65486725663717,0.884955752212389,37.1681415929204,12.3893805309735,46.9026548672566,3.53982300884956,4.42477876106195,28.3185840707965,10.6194690265487
"E00167248",281,8,13,141,119,192,1,8,87,96,89,7,5,54,23,2.84697508896797,4.62633451957295,50.1779359430605,42.3487544483986,68.3274021352313,0.355871886120996,2.84697508896797,30.9608540925267,34.1637010676157,31.6725978647687,2.49110320284698,1.77935943060498,19.2170818505338,8.18505338078292
"E00167249",251,6,6,111,128,172,3,5,71,93,79,3,1,40,35,2.39043824701195,2.39043824701195,44.2231075697211,50.996015936255,68.5258964143426,1.19521912350598,1.99203187250996,28.2868525896414,37.0517928286853,31.4741035856574,1.19521912350598,0.398406374501992,15.9362549800797,13.9442231075697
"E00167250",87,11,32,36,8,46,3,18,19,6,41,8,14,17,2,12.6436781609195,36.7816091954023,41.3793103448276,9.19540229885057,52.8735632183908,3.44827586206897,20.6896551724138,21.8390804597701,6.89655172413793,47.1264367816092,9.19540229885057,16.0919540229885,19.5402298850575,2.29885057471264
"E00167251",193,118,46,23,6,66,35,19,9,3,127,83,27,14,3,61.139896373057,23.8341968911917,11.9170984455959,3.10880829015544,34.1968911917098,18.1347150259067,9.84455958549223,4.66321243523316,1.55440414507772,65.8031088082902,43.0051813471503,13.9896373056995,7.25388601036269,1.55440414507772
"E00167252",167,14,28,105,20,91,5,15,57,14,76,9,13,48,6,8.38323353293413,16.7664670658683,62.874251497006,11.9760479041916,54.4910179640719,2.9940119760479,8.98203592814371,34.1317365269461,8.38323353293413,45.5089820359281,5.38922155688623,7.78443113772455,28.7425149700599,3.59281437125748
"E00167253",173,10,28,119,16,90,4,15,61,10,83,6,13,58,6,5.78034682080925,16.1849710982659,68.7861271676301,9.2485549132948,52.0231213872832,2.3121387283237,8.67052023121387,35.2601156069364,5.78034682080925,47.9768786127168,3.46820809248555,7.51445086705202,33.5260115606936,3.46820809248555
"E00167254",68,13,16,36,3,32,5,7,17,3,36,8,9,19,0,19.1176470588235,23.5294117647059,52.9411764705882,4.41176470588235,47.0588235294118,7.35294117647059,10.2941176470588,25,4.41176470588235,52.9411764705882,11.7647058823529,13.2352941176471,27.9411764705882,0
"E00167255",135,16,19,82,18,75,10,10,42,13,60,6,9,40,5,11.8518518518519,14.0740740740741,60.7407407407407,13.3333333333333,55.5555555555556,7.40740740740741,7.40740740740741,31.1111111111111,9.62962962962963,44.4444444444444,4.44444444444444,6.66666666666667,29.6296296296296,3.7037037037037
"E00167256",179,6,18,131,24,97,3,11,67,16,82,3,7,64,8,3.35195530726257,10.0558659217877,73.1843575418994,13.4078212290503,54.1899441340782,1.67597765363128,6.14525139664804,37.4301675977654,8.93854748603352,45.8100558659218,1.67597765363128,3.91061452513966,35.7541899441341,4.46927374301676
"E00167257",222,6,38,143,35,118,3,14,79,22,104,3,24,64,13,2.7027027027027,17.1171171171171,64.4144144144144,15.7657657657658,53.1531531531532,1.35135135135135,6.30630630630631,35.5855855855856,9.90990990990991,46.8468468468468,1.35135135135135,10.8108108108108,28.8288288288288,5.85585585585586
"E00167258",98,19,33,44,2,65,10,24,29,2,33,9,9,15,0,19.3877551020408,33.6734693877551,44.8979591836735,2.04081632653061,66.3265306122449,10.2040816326531,24.4897959183673,29.5918367346939,2.04081632653061,33.6734693877551,9.18367346938776,9.18367346938776,15.3061224489796,0
"E00167259",69,3,27,37,2,46,1,21,22,2,23,2,6,15,0,4.34782608695652,39.1304347826087,53.6231884057971,2.89855072463768,66.6666666666667,1.44927536231884,30.4347826086957,31.8840579710145,2.89855072463768,33.3333333333333,2.89855072463768,8.69565217391304,21.7391304347826,0
"E00167260",156,18,42,88,8,81,9,23,45,4,75,9,19,43,4,11.5384615384615,26.9230769230769,56.4102564102564,5.12820512820513,51.9230769230769,5.76923076923077,14.7435897435897,28.8461538461538,2.56410256410256,48.0769230769231,5.76923076923077,12.1794871794872,27.5641025641026,2.56410256410256
"E00167261",205,20,35,108,42,113,12,14,58,29,92,8,21,50,13,9.75609756097561,17.0731707317073,52.6829268292683,20.4878048780488,55.1219512195122,5.85365853658537,6.82926829268293,28.2926829268293,14.1463414634146,44.8780487804878,3.90243902439024,10.2439024390244,24.390243902439,6.34146341463415
"E00167262",63,3,4,40,16,34,1,2,22,9,29,2,2,18,7,4.76190476190476,6.34920634920635,63.4920634920635,25.3968253968254,53.968253968254,1.58730158730159,3.17460317460317,34.9206349206349,14.2857142857143,46.031746031746,3.17460317460317,3.17460317460317,28.5714285714286,11.1111111111111
"E00167263",155,14,7,85,49,84,6,1,44,33,71,8,6,41,16,9.03225806451613,4.51612903225806,54.8387096774194,31.6129032258064,54.1935483870968,3.87096774193548,0.645161290322581,28.3870967741935,21.2903225806452,45.8064516129032,5.16129032258065,3.87096774193548,26.4516129032258,10.3225806451613
"E00167264",137,18,23,81,15,69,7,14,37,11,68,11,9,44,4,13.1386861313869,16.7883211678832,59.1240875912409,10.9489051094891,50.3649635036496,5.10948905109489,10.2189781021898,27.007299270073,8.02919708029197,49.6350364963504,8.02919708029197,6.56934306569343,32.1167883211679,2.91970802919708
"E00167265",131,22,28,65,16,77,14,18,34,11,54,8,10,31,5,16.793893129771,21.3740458015267,49.618320610687,12.2137404580153,58.7786259541985,10.6870229007634,13.7404580152672,25.9541984732824,8.3969465648855,41.2213740458015,6.10687022900763,7.63358778625954,23.6641221374046,3.81679389312977
"E00167266",156,15,18,97,26,82,7,9,49,17,74,8,9,48,9,9.61538461538462,11.5384615384615,62.1794871794872,16.6666666666667,52.5641025641026,4.48717948717949,5.76923076923077,31.4102564102564,10.8974358974359,47.4358974358974,5.12820512820513,5.76923076923077,30.7692307692308,5.76923076923077
