"GeographyCode","QS403EW0001","QS403EW0002","QS403EW0003","QS403EW0004","QS403EW0005","QS403EW0006","QS403EW0007","QS403EW0008","QS403EW0009","QS403EW0010","QS403EW0011","QS403EW0012","QS403EW0013","QS403EW0014"
"E00021141",333,6,5,1,5,299,41,258,23,19,1,0,3,0
"E00021143",393,55,11,44,0,265,249,16,71,71,0,0,0,2
"E00021145",241,52,27,25,0,142,15,127,46,40,6,0,0,1
"E00021146",293,67,17,50,2,43,2,41,179,175,0,2,2,2
"E00021147",205,40,21,19,0,102,6,96,58,57,0,0,1,5
"E00021148",279,39,12,27,4,147,93,54,82,72,7,3,0,7
"E00021149",353,57,17,40,1,250,76,174,41,33,0,6,2,4
"E00021150",298,63,17,46,0,189,175,14,46,46,0,0,0,0
"E00021151",275,9,5,4,0,219,74,145,47,47,0,0,0,0
"E00021152",379,81,12,69,0,263,141,122,33,33,0,0,0,2
"E00021153",341,36,4,32,0,26,14,12,276,267,2,7,0,3
"E00021154",401,27,8,19,22,299,193,106,47,47,0,0,0,6
"E00021155",359,99,24,75,2,30,0,30,228,211,0,9,8,0
"E00021156",237,27,11,16,2,155,90,65,52,45,0,7,0,1
"E00021157",331,29,14,15,7,236,120,116,59,57,0,2,0,0
"E00021158",340,37,8,29,0,277,147,130,25,25,0,0,0,1
"E00021159",571,150,35,115,0,264,120,144,148,129,4,11,4,9
"E00021160",322,68,29,39,0,173,160,13,78,75,0,3,0,3
"E00021161",391,111,47,64,0,176,62,114,95,90,0,5,0,9
"E00021162",375,82,36,46,3,172,155,17,117,115,0,2,0,1
"E00021163",309,60,33,27,1,185,64,121,62,49,0,4,9,1
"E00021164",279,58,32,26,0,200,71,129,16,11,0,0,5,5
"E00021165",338,61,8,53,1,206,180,26,62,62,0,0,0,8
"E00021166",387,72,18,54,0,176,90,86,139,138,0,1,0,0
"E00021167",305,88,36,52,0,122,56,66,92,82,0,10,0,3
"E00021168",374,94,21,73,4,15,10,5,258,246,4,6,2,3
"E00021169",467,91,25,66,27,214,87,127,132,113,0,5,14,3
"E00021170",466,63,17,46,0,326,319,7,77,58,2,11,6,0
"E00021171",660,70,18,52,0,412,243,169,169,164,0,5,0,9
"E00021172",275,26,15,11,7,183,13,170,49,45,0,0,4,10
"E00021173",372,108,21,87,0,183,168,15,80,76,0,3,1,1
"E00021174",228,123,43,80,0,1,1,0,103,101,0,2,0,1
"E00021175",288,69,21,48,6,93,86,7,102,96,2,4,0,18
"E00021176",298,59,14,45,12,166,119,47,58,56,0,2,0,3
"E00021177",425,73,22,51,0,273,114,159,79,77,0,2,0,0
"E00021179",327,85,24,61,3,51,30,21,184,171,0,10,3,4
"E00021180",444,57,19,38,4,243,157,86,137,126,0,11,0,3
"E00021181",230,60,11,49,0,66,37,29,100,94,0,6,0,4
"E00021182",343,79,32,47,0,49,15,34,213,213,0,0,0,2
"E00021183",231,107,28,79,6,21,1,20,95,93,0,2,0,2
"E00021184",169,24,4,20,19,72,70,2,54,54,0,0,0,0
"E00021185",299,64,26,38,6,164,14,150,64,64,0,0,0,1
"E00021186",440,96,17,79,0,233,211,22,105,102,0,2,1,6
"E00021187",307,35,23,12,0,192,163,29,74,66,0,5,3,6
"E00021188",302,36,4,32,0,203,18,185,61,57,0,3,1,2
"E00021189",397,99,42,57,0,179,168,11,109,101,0,2,6,10
"E00021190",452,92,23,69,3,138,136,2,206,200,0,6,0,13
"E00021191",396,156,44,112,9,129,125,4,102,82,0,20,0,0
"E00021192",329,54,22,32,5,158,148,10,109,103,0,0,6,3
"E00021193",323,97,30,67,0,12,12,0,209,188,0,16,5,5
"E00021194",563,72,33,39,26,321,191,130,143,138,0,0,5,1
"E00021195",392,75,17,58,1,238,232,6,78,78,0,0,0,0
"E00021196",381,36,9,27,5,308,181,127,26,24,0,2,0,6
"E00021197",415,135,55,80,3,125,80,45,143,136,0,1,6,9
"E00021198",313,113,48,65,0,131,94,37,62,62,0,0,0,7
"E00021199",182,4,2,2,0,170,41,129,8,5,0,0,3,0
"E00021200",322,49,16,33,6,161,154,7,105,103,1,1,0,1
"E00021201",321,100,37,63,1,116,108,8,102,96,0,6,0,2
"E00021202",285,69,9,60,0,167,142,25,42,36,0,6,0,7
"E00021203",246,45,15,30,0,121,99,22,79,76,0,0,3,1
"E00021204",401,69,11,58,3,252,18,234,74,69,0,2,3,3
"E00021205",336,69,24,45,0,187,164,23,76,76,0,0,0,4
"E00021206",239,37,10,27,0,175,160,15,24,24,0,0,0,3
"E00021207",256,69,17,52,1,40,3,37,143,141,0,2,0,3
"E00021208",299,63,15,48,6,165,125,40,63,61,0,2,0,2
"E00021209",246,45,5,40,5,142,127,15,54,52,0,2,0,0
"E00021210",289,73,16,57,1,146,124,22,67,60,0,0,7,2
"E00021211",372,64,14,50,0,148,146,2,147,147,0,0,0,13
"E00021212",270,53,6,47,1,153,125,28,63,60,0,0,3,0
"E00021213",415,62,9,53,0,234,173,61,118,107,0,3,8,1
"E00021214",442,101,27,74,1,203,169,34,130,116,0,2,12,7
"E00021215",344,103,32,71,4,20,17,3,216,205,0,8,3,1
"E00021216",325,14,2,12,7,218,88,130,80,77,0,3,0,6
"E00021217",452,65,24,41,4,223,153,70,157,145,0,0,12,3
"E00021218",491,190,57,133,2,70,23,47,218,216,0,2,0,11
"E00021219",250,111,48,63,1,92,26,66,46,38,0,2,6,0
"E00021220",348,116,22,94,3,53,5,48,174,164,0,10,0,2
"E00021223",388,106,20,86,0,77,0,77,203,190,5,6,2,2
"E00021224",409,121,54,67,2,130,37,93,152,141,0,9,2,4
"E00021225",292,50,15,35,0,142,26,116,98,95,2,0,1,2
"E00021227",269,125,46,79,2,68,10,58,74,74,0,0,0,0
"E00021228",359,143,60,83,3,110,44,66,93,89,0,4,0,10
"E00021229",309,56,6,50,0,195,48,147,41,39,0,2,0,17
"E00021230",248,131,58,73,0,54,12,42,60,58,0,1,1,3
"E00021231",210,35,13,22,0,139,23,116,35,27,0,7,1,1
"E00021235",368,45,2,43,0,302,288,14,16,16,0,0,0,5
"E00021236",324,47,6,41,2,168,146,22,104,100,0,0,4,3
"E00021238",398,151,67,84,0,10,0,10,232,231,0,1,0,5
"E00021239",286,98,40,58,0,3,0,3,178,173,0,3,2,7
"E00021240",304,89,27,62,0,35,4,31,173,169,0,4,0,7
"E00021241",274,130,30,100,0,14,2,12,129,127,0,0,2,1
"E00021243",398,41,2,39,0,253,115,138,103,100,0,1,2,1
"E00021244",254,28,3,25,5,202,39,163,18,17,0,1,0,1
"E00021245",246,90,36,54,2,87,19,68,65,65,0,0,0,2
"E00021246",517,77,23,54,62,269,83,186,93,90,0,0,3,16
"E00021247",402,48,11,37,5,273,96,177,76,72,0,1,3,0
"E00021248",380,38,12,26,0,298,77,221,44,37,0,0,7,0
"E00021249",329,11,6,5,7,287,26,261,17,17,0,0,0,7
"E00021251",292,81,29,52,0,127,28,99,71,67,0,0,4,13
"E00021252",267,94,40,54,0,1,0,1,166,158,0,8,0,6
"E00021253",304,41,6,35,0,183,75,108,72,63,0,4,5,8
"E00021254",237,80,15,65,0,5,0,5,150,141,0,5,4,2
"E00021255",221,107,16,91,3,8,0,8,103,101,0,0,2,0
"E00021256",242,90,13,77,1,4,0,4,147,143,0,4,0,0
"E00021257",242,110,38,72,16,16,0,16,94,93,0,1,0,6
"E00021258",360,79,23,56,4,214,67,147,63,60,0,0,3,0
"E00021259",399,103,34,69,6,165,80,85,120,116,0,4,0,5
"E00021260",320,69,32,37,0,174,63,111,72,68,0,4,0,5
"E00021261",278,49,2,47,3,133,11,122,92,84,0,4,4,1
"E00021262",305,49,8,41,6,183,171,12,66,66,0,0,0,1
"E00021263",401,180,52,128,26,104,35,69,79,75,4,0,0,12
"E00021266",281,85,29,56,0,104,33,71,92,88,0,4,0,0
"E00021267",329,56,22,34,0,207,24,183,65,64,0,1,0,1
"E00021268",253,30,8,22,4,153,39,114,66,62,0,4,0,0
"E00021271",392,42,21,21,3,330,16,314,16,13,0,3,0,1
"E00021272",221,30,7,23,3,134,29,105,48,48,0,0,0,6
"E00021273",285,71,28,43,5,182,58,124,25,24,0,1,0,2
"E00021274",549,73,18,55,2,404,68,336,66,64,0,0,2,4
"E00021275",259,39,16,23,0,195,79,116,25,25,0,0,0,0
"E00021277",249,13,1,12,0,216,20,196,10,10,0,0,0,10
"E00021278",199,14,1,13,0,135,26,109,50,48,0,2,0,0
"E00021279",444,57,9,48,1,327,69,258,45,39,0,6,0,14
"E00021280",287,56,28,28,3,97,41,56,126,121,0,3,2,5
"E00021281",531,98,34,64,38,199,105,94,195,187,0,4,4,1
"E00021282",407,94,19,75,15,181,62,119,117,111,0,3,3,0
"E00021285",123,28,4,24,47,15,10,5,33,30,0,3,0,0
"E00021286",230,94,43,51,2,36,13,23,98,98,0,0,0,0
"E00021287",278,110,16,94,0,4,1,3,164,160,0,4,0,0
"E00021288",239,114,28,86,0,7,2,5,117,111,0,6,0,1
"E00021289",330,17,6,11,6,290,274,16,17,17,0,0,0,0
"E00021290",342,63,21,42,1,212,184,28,56,55,0,1,0,10
"E00021291",374,140,34,106,0,6,1,5,224,216,0,7,1,4
"E00021292",312,58,32,26,0,173,148,25,79,79,0,0,0,2
"E00021294",578,48,21,27,0,491,96,395,37,37,0,0,0,2
"E00021295",379,114,39,75,5,94,27,67,141,134,0,7,0,25
"E00021296",341,93,29,64,0,128,2,126,117,112,0,5,0,3
"E00021297",415,165,57,108,6,140,28,112,94,94,0,0,0,10
"E00021298",417,179,51,128,38,62,3,59,130,126,0,4,0,8
"E00021299",438,130,34,96,40,112,83,29,155,148,0,2,5,1
"E00021300",488,227,86,141,6,48,6,42,202,189,0,13,0,5
"E00021301",522,88,17,71,1,335,206,129,88,83,4,1,0,10
"E00021302",463,106,39,67,12,181,71,110,160,156,0,4,0,4
"E00021303",349,85,19,66,0,176,153,23,88,86,0,0,2,0
"E00021304",351,72,34,38,2,143,29,114,129,129,0,0,0,5
"E00021305",255,155,86,69,0,31,7,24,69,63,0,4,2,0
"E00021306",264,128,49,79,5,48,28,20,74,69,0,3,2,9
"E00021307",456,143,50,93,3,56,14,42,252,238,0,13,1,2
"E00021308",432,98,58,40,5,186,108,78,141,141,0,0,0,2
"E00021309",189,68,13,55,0,10,0,10,111,107,0,4,0,0
"E00021310",259,104,52,52,0,95,28,67,60,58,0,2,0,0
"E00021311",335,75,34,41,0,203,15,188,57,54,2,1,0,0
"E00021312",316,102,40,62,8,123,28,95,81,76,0,4,1,2
"E00021313",484,156,42,114,0,124,63,61,198,185,0,11,2,6
"E00021314",370,230,73,157,0,61,4,57,77,77,0,0,0,2
"E00021315",138,0,0,0,0,134,17,117,4,4,0,0,0,0
"E00021316",322,86,29,57,0,161,22,139,66,66,0,0,0,9
"E00021317",328,209,65,144,0,41,7,34,78,78,0,0,0,0
"E00021318",303,76,19,57,2,88,65,23,136,128,0,8,0,1
"E00021319",330,56,17,39,2,147,48,99,125,125,0,0,0,0
"E00021320",317,106,30,76,11,142,91,51,48,45,0,3,0,10
"E00021321",302,91,38,53,0,129,18,111,82,75,0,4,3,0
"E00021322",315,57,21,36,3,171,27,144,83,74,0,9,0,1
"E00021323",374,35,8,27,3,211,148,63,113,104,0,6,3,12
"E00021324",380,139,41,98,3,91,9,82,138,138,0,0,0,9
"E00021325",413,107,44,63,7,210,43,167,85,79,0,6,0,4
"E00021326",433,93,17,76,2,252,228,24,86,78,0,8,0,0
"E00021327",397,103,31,72,17,181,10,171,93,77,4,9,3,3
"E00021328",434,56,13,43,4,234,203,31,130,130,0,0,0,10
"E00021329",398,45,17,28,3,248,149,99,94,89,0,0,5,8
"E00021330",334,35,13,22,2,208,130,78,73,68,0,3,2,16
"E00021331",200,13,2,11,0,144,40,104,40,36,0,1,3,3
"E00021332",491,59,6,53,3,363,185,178,65,56,0,4,5,1
"E00021333",351,78,19,59,1,192,102,90,77,73,3,1,0,3
"E00021334",377,97,21,76,0,220,178,42,58,45,0,11,2,2
"E00021335",564,64,32,32,12,384,77,307,87,87,0,0,0,17
"E00021336",300,48,9,39,0,218,104,114,26,26,0,0,0,8
"E00021337",339,34,2,32,17,265,22,243,21,21,0,0,0,2
"E00021338",452,86,42,44,2,265,89,176,95,79,5,2,9,4
"E00021339",331,76,42,34,9,112,95,17,131,122,0,9,0,3
"E00021340",383,45,6,39,0,97,26,71,234,234,0,0,0,7
"E00021342",342,43,15,28,0,257,103,154,42,42,0,0,0,0
"E00021344",534,49,20,29,13,365,188,177,107,97,0,10,0,0
"E00021345",348,40,10,30,0,217,95,122,91,82,0,4,5,0
"E00021346",341,38,4,34,19,210,97,113,74,67,0,2,5,0
"E00021347",408,31,3,28,5,303,161,142,69,63,0,2,4,0
"E00021349",399,55,7,48,0,264,132,132,72,64,0,6,2,8
"E00021350",354,63,8,55,6,177,33,144,97,97,0,0,0,11
"E00021351",381,53,12,41,0,251,107,144,72,71,0,1,0,5
"E00021352",284,34,3,31,0,214,22,192,36,36,0,0,0,0
"E00021353",308,27,0,27,0,189,71,118,80,75,0,1,4,12
"E00021354",463,52,17,35,21,325,24,301,60,48,0,5,7,5
"E00021355",300,97,39,58,1,58,16,42,144,125,0,19,0,0
"E00021357",412,97,9,88,0,265,120,145,44,36,0,0,8,6
"E00021359",369,57,17,40,3,230,71,159,79,79,0,0,0,0
"E00021360",450,51,11,40,2,247,132,115,150,145,0,2,3,0
"E00021361",371,19,9,10,20,290,37,253,33,30,0,3,0,9
"E00021363",389,73,13,60,1,229,103,126,83,82,0,0,1,3
"E00021364",570,180,67,113,1,253,92,161,132,125,4,0,3,4
"E00021365",282,54,17,37,0,133,51,82,90,78,0,8,4,5
"E00021366",371,61,35,26,1,226,90,136,76,75,0,0,1,7
"E00021367",318,80,19,61,4,153,33,120,80,68,0,8,4,1
"E00021368",399,50,19,31,0,289,104,185,57,41,0,4,12,3
"E00021369",232,45,13,32,0,183,62,121,4,4,0,0,0,0
"E00021370",616,116,23,93,7,377,101,276,110,109,0,0,1,6
"E00021371",199,18,2,16,0,168,38,130,11,11,0,0,0,2
"E00021372",385,82,41,41,12,190,106,84,96,96,0,0,0,5
"E00021374",420,61,21,40,4,303,111,192,51,45,0,2,4,1
"E00021375",389,34,15,19,0,292,85,207,56,56,0,0,0,7
"E00021376",384,62,10,52,0,224,107,117,92,91,0,0,1,6
"E00021377",586,108,31,77,16,263,126,137,193,178,8,6,1,6
"E00021378",424,80,23,57,0,169,66,103,175,174,0,1,0,0
"E00021379",283,84,47,37,2,107,42,65,89,87,0,2,0,1
"E00021380",232,24,6,18,1,116,55,61,91,87,2,2,0,0
"E00021381",410,37,12,25,0,287,153,134,81,79,0,0,2,5
"E00021382",411,27,12,15,0,335,109,226,46,39,0,0,7,3
"E00021383",523,48,9,39,0,388,149,239,83,67,0,0,16,4
"E00021384",220,147,28,119,2,1,1,0,66,53,2,11,0,4
"E00021385",433,110,47,63,73,114,51,63,131,125,0,6,0,5
"E00021386",360,61,18,43,7,240,93,147,50,50,0,0,0,2
"E00021387",664,96,21,75,41,407,122,285,109,101,0,7,1,11
"E00021388",330,24,10,14,0,227,64,163,75,75,0,0,0,4
"E00021391",492,26,5,21,0,366,183,183,93,82,0,3,8,7
"E00021392",369,175,67,108,36,58,34,24,96,96,0,0,0,4
"E00021393",423,37,17,20,0,298,118,180,88,77,0,1,10,0
"E00021394",358,31,15,16,0,262,82,180,65,58,0,0,7,0
"E00021395",336,10,0,10,2,255,84,171,67,62,0,0,5,2
"E00021396",351,48,25,23,5,250,127,123,48,39,0,1,8,0
"E00021397",566,80,26,54,4,395,121,274,79,79,0,0,0,8
"E00021398",474,92,20,72,9,246,121,125,127,118,0,2,7,0
"E00021399",371,173,85,88,0,63,60,3,105,97,4,3,1,30
"E00021400",394,90,29,61,0,128,89,39,174,171,0,2,1,2
"E00021402",276,54,11,43,0,145,63,82,74,69,0,0,5,3
"E00021404",256,101,33,68,0,5,5,0,148,140,1,5,2,2
"E00021405",429,188,88,100,0,101,39,62,140,126,4,5,5,0
"E00021406",371,46,13,33,2,251,128,123,69,67,1,1,0,3
"E00021407",540,58,13,45,2,414,156,258,53,50,0,3,0,13
"E00021408",340,97,18,79,23,44,20,24,173,173,0,0,0,3
"E00021409",274,133,36,97,0,3,0,3,133,125,0,8,0,5
"E00021410",316,96,7,89,0,122,94,28,91,88,0,2,1,7
"E00021411",389,123,45,78,0,210,193,17,54,50,2,2,0,2
"E00021412",440,69,26,43,2,321,241,80,40,40,0,0,0,8
"E00021413",413,70,8,62,24,248,159,89,59,58,0,0,1,12
"E00021414",402,93,6,87,0,217,203,14,91,91,0,0,0,1
"E00021415",379,47,11,36,9,247,214,33,76,69,0,7,0,0
"E00021416",369,93,38,55,0,187,179,8,86,78,0,4,4,3
"E00021417",275,60,28,32,0,132,126,6,81,80,0,1,0,2
"E00021418",213,109,33,76,2,10,10,0,92,82,0,8,2,0
"E00021419",445,33,13,20,0,277,259,18,130,121,0,4,5,5
"E00021420",285,105,39,66,2,112,76,36,61,61,0,0,0,5
"E00021421",448,85,24,61,13,268,170,98,82,78,0,1,3,0
"E00021422",209,14,6,8,0,131,59,72,57,49,0,1,7,7
"E00021423",417,62,12,50,0,246,211,35,106,100,0,6,0,3
"E00021424",212,113,45,68,0,4,3,1,95,90,0,5,0,0
"E00021425",232,110,41,69,1,1,0,1,114,114,0,0,0,6
"E00021426",349,32,14,18,0,241,86,155,64,60,0,4,0,12
"E00021427",229,98,34,64,1,3,3,0,125,118,1,6,0,2
"E00021428",393,50,16,34,0,265,116,149,69,63,0,4,2,9
"E00021429",141,26,6,20,17,69,7,62,29,26,0,0,3,0
"E00021430",331,71,9,62,3,209,204,5,42,42,0,0,0,6
"E00021431",319,85,31,54,0,157,140,17,77,73,0,4,0,0
"E00021432",387,76,28,48,0,241,226,15,70,69,0,0,1,0
"E00021433",624,162,21,141,0,288,194,94,172,169,0,3,0,2
"E00021434",421,122,40,82,0,193,186,7,106,106,0,0,0,0
"E00021437",318,65,26,39,2,172,72,100,79,74,0,0,5,0
"E00021438",210,51,25,26,1,114,51,63,39,37,0,1,1,5
"E00021439",236,27,10,17,0,130,123,7,77,77,0,0,0,2
"E00021440",451,171,59,112,0,138,134,4,131,107,0,18,6,11
"E00021441",358,142,63,79,0,169,2,167,45,34,0,10,1,2
"E00021442",335,26,10,16,3,254,10,244,47,47,0,0,0,5
"E00021443",247,36,5,31,0,155,19,136,55,52,0,0,3,1
"E00021444",325,49,26,23,0,175,36,139,93,62,0,0,31,8
"E00021445",422,59,16,43,1,277,262,15,82,68,0,0,14,3
"E00021446",448,77,17,60,0,319,315,4,52,52,0,0,0,0
"E00021447",266,116,25,91,9,25,22,3,116,112,0,3,1,0
"E00021448",337,50,15,35,0,247,211,36,36,33,0,3,0,4
"E00021449",333,75,21,54,9,127,66,61,119,113,0,6,0,3
"E00021450",187,98,45,53,1,43,0,43,43,43,0,0,0,2
"E00021451",400,53,22,31,0,286,262,24,59,53,0,6,0,2
"E00021452",212,60,21,39,12,83,78,5,56,54,0,1,1,1
"E00021453",310,45,20,25,4,156,81,75,95,91,0,4,0,10
"E00021454",357,36,4,32,0,257,83,174,64,60,0,4,0,0
"E00021455",346,49,20,29,0,259,245,14,38,34,0,4,0,0
"E00021458",259,96,30,66,4,36,19,17,120,116,0,4,0,3
"E00021459",256,88,24,64,3,42,35,7,123,117,0,6,0,0
"E00021460",385,103,37,66,4,133,117,16,145,143,0,2,0,0
"E00021461",250,79,20,59,4,109,97,12,58,50,0,8,0,0
"E00021462",314,61,29,32,0,179,179,0,74,71,3,0,0,0
"E00021463",338,101,30,71,0,157,154,3,73,72,0,1,0,7
"E00021464",279,42,7,35,0,138,62,76,99,97,0,2,0,0
"E00021465",416,85,18,67,5,226,208,18,87,84,0,3,0,13
"E00021466",382,65,27,38,0,176,155,21,141,72,0,0,69,0
"E00021467",371,47,20,27,0,215,195,20,97,59,0,0,38,12
"E00021468",265,42,14,28,15,115,105,10,89,81,0,4,4,4
"E00021469",446,61,26,35,7,242,228,14,114,114,0,0,0,22
"E00021470",282,69,24,45,9,115,104,11,77,70,1,4,2,12
"E00021471",373,75,19,56,6,239,190,49,47,45,0,2,0,6
"E00021473",299,58,17,41,6,141,129,12,94,61,0,0,33,0
"E00021474",402,89,40,49,1,204,201,3,106,103,0,0,3,2
"E00021475",377,88,22,66,3,155,132,23,123,119,1,0,3,8
"E00021476",406,86,12,74,0,199,80,119,119,114,0,4,1,2
"E00021477",460,83,23,60,4,173,28,145,169,163,4,2,0,31
"E00021478",333,82,40,42,0,145,26,119,95,85,0,6,4,11
"E00021479",411,74,23,51,4,82,12,70,248,240,0,6,2,3
"E00021480",303,77,17,60,0,57,10,47,169,161,0,8,0,0
"E00021481",413,61,24,37,0,191,72,119,161,148,0,10,3,0
"E00021482",455,128,37,91,2,138,39,99,186,175,0,9,2,1
"E00021483",600,155,29,126,6,147,36,111,291,271,0,19,1,1
"E00021484",364,124,34,90,7,41,8,33,190,182,0,8,0,2
"E00021485",330,12,1,11,2,258,34,224,52,52,0,0,0,6
"E00021486",387,75,35,40,0,190,78,112,122,107,0,8,7,0
"E00021487",220,21,2,19,0,178,87,91,5,2,0,2,1,16
"E00021488",444,83,15,68,12,216,92,124,127,127,0,0,0,6
"E00021489",346,48,10,38,0,204,63,141,87,85,0,2,0,7
"E00021490",306,52,7,45,0,183,69,114,60,50,0,4,6,11
"E00021491",285,42,4,38,1,219,76,143,23,23,0,0,0,0
"E00021492",372,46,6,40,4,223,99,124,89,86,0,0,3,10
"E00021493",481,37,12,25,0,368,202,166,76,73,0,0,3,0
"E00021494",546,102,30,72,0,365,73,292,65,63,0,2,0,14
"E00021495",609,80,24,56,0,433,199,234,95,88,0,7,0,1
"E00021496",360,45,11,34,1,243,75,168,71,65,0,0,6,0
"E00021497",517,74,12,62,0,359,175,184,83,79,0,0,4,1
"E00021498",389,44,6,38,0,313,133,180,30,29,0,0,1,2
"E00021499",306,65,10,55,0,113,13,100,119,112,0,7,0,9
"E00021500",310,57,14,43,0,148,7,141,102,98,0,4,0,3
"E00021501",292,26,13,13,0,170,76,94,96,95,0,0,1,0
"E00021502",375,6,1,5,0,353,24,329,14,14,0,0,0,2
"E00021503",393,62,8,54,0,274,87,187,51,40,0,7,4,6
"E00021504",399,30,4,26,0,264,72,192,101,101,0,0,0,4
"E00021505",296,60,26,34,0,189,31,158,45,45,0,0,0,2
"E00021506",317,54,17,37,1,181,58,123,80,80,0,0,0,1
"E00021507",376,34,8,26,0,202,66,136,137,135,0,2,0,3
"E00021508",358,67,27,40,0,156,68,88,133,130,0,0,3,2
"E00021509",499,79,28,51,1,280,115,165,139,135,0,4,0,0
"E00021510",240,86,47,39,0,8,5,3,144,141,0,3,0,2
"E00021511",205,81,26,55,0,5,0,5,119,111,3,3,2,0
"E00021516",252,61,21,40,0,129,4,125,55,55,0,0,0,7
"E00021517",304,66,19,47,3,118,9,109,116,111,0,3,2,1
"E00021518",337,59,13,46,0,106,0,106,164,159,0,0,5,8
"E00021519",463,175,41,134,11,60,28,32,215,209,0,6,0,2
"E00021520",216,77,10,67,1,15,5,10,121,121,0,0,0,2
"E00021521",259,104,28,76,3,111,25,86,41,31,6,4,0,0
"E00021522",468,41,5,36,4,357,48,309,61,58,0,3,0,5
"E00021524",590,75,18,57,2,297,36,261,211,205,0,6,0,5
"E00021525",308,92,24,68,0,32,9,23,179,176,2,1,0,5
"E00021526",342,107,21,86,0,7,0,7,224,221,0,3,0,4
"E00021527",317,98,36,62,0,7,5,2,212,208,0,4,0,0
"E00021528",259,99,36,63,3,116,41,75,40,40,0,0,0,1
"E00021529",192,22,4,18,4,135,4,131,28,28,0,0,0,3
"E00021531",597,122,35,87,0,357,130,227,109,100,0,7,2,9
"E00021532",318,129,46,83,0,2,0,2,185,180,0,5,0,2
"E00021533",242,114,31,83,1,2,0,2,117,114,0,3,0,8
"E00021534",225,81,31,50,1,2,0,2,140,137,0,2,1,1
"E00021535",286,105,36,69,19,45,16,29,101,96,0,0,5,16
"E00021536",282,119,22,97,0,8,6,2,155,155,0,0,0,0
"E00021537",339,159,49,110,0,6,0,6,165,158,0,7,0,9
"E00021538",684,265,88,177,6,3,3,0,406,396,0,8,2,4
"E00021539",252,78,16,62,0,4,3,1,165,162,0,0,3,5
"E00021541",229,63,21,42,0,16,0,16,146,140,0,6,0,4
"E00021542",218,76,19,57,1,3,0,3,119,68,47,2,2,19
"E00021543",270,100,37,63,0,3,0,3,165,161,0,2,2,2
"E00021544",180,98,24,74,0,11,0,11,71,67,0,3,1,0
"E00021546",196,75,24,51,0,0,0,0,118,117,1,0,0,3
"E00021547",278,74,17,57,0,153,36,117,48,43,0,5,0,3
"E00021549",386,63,20,43,13,230,47,183,77,77,0,0,0,3
"E00021550",402,39,15,24,3,309,62,247,49,43,0,0,6,2
"E00021552",241,59,19,40,0,131,36,95,51,50,0,1,0,0
"E00021553",349,21,7,14,0,278,42,236,42,36,0,1,5,8
"E00021554",259,64,19,45,30,49,9,40,115,110,0,0,5,1
"E00021555",447,44,20,24,0,286,70,216,106,106,0,0,0,11
"E00021556",285,106,32,74,0,4,2,2,174,164,0,10,0,1
"E00021557",340,123,24,99,0,6,0,6,209,207,0,2,0,2
"E00021559",338,143,40,103,1,142,98,44,52,52,0,0,0,0
"E00021560",431,54,9,45,16,290,132,158,58,54,0,4,0,13
"E00021561",278,50,25,25,2,42,6,36,182,171,0,5,6,2
"E00021562",372,119,41,78,0,126,115,11,112,110,0,2,0,15
"E00021563",391,77,27,50,1,235,58,177,78,73,0,3,2,0
"E00021564",313,78,34,44,3,125,14,111,102,87,0,9,6,5
"E00021565",207,21,11,10,0,142,94,48,44,41,0,0,3,0
"E00021566",446,94,45,49,1,141,51,90,201,197,0,4,0,9
"E00021567",351,140,54,86,7,74,64,10,128,118,0,5,5,2
"E00021569",302,62,28,34,0,101,7,94,134,121,0,0,13,5
"E00021572",359,77,26,51,4,156,48,108,122,118,0,4,0,0
"E00021574",267,78,15,63,0,104,71,33,81,79,0,2,0,4
"E00021577",291,22,9,13,0,240,32,208,17,16,0,0,1,12
"E00021579",362,118,31,87,0,188,131,57,52,52,0,0,0,4
"E00021580",423,79,25,54,4,252,186,66,88,77,0,11,0,0
"E00021582",401,67,25,42,5,266,61,205,52,52,0,0,0,11
"E00021583",434,87,23,64,0,260,194,66,82,65,0,9,8,5
"E00021584",302,47,11,36,12,214,60,154,28,24,0,0,4,1
"E00021585",590,89,19,70,8,371,191,180,108,106,0,2,0,14
"E00021586",455,124,24,100,0,209,117,92,119,105,0,14,0,3
"E00021587",396,63,19,44,6,222,200,22,105,105,0,0,0,0
"E00021588",333,69,11,58,0,212,54,158,46,46,0,0,0,6
"E00021590",376,108,53,55,0,195,41,154,72,72,0,0,0,1
"E00021591",461,12,4,8,0,418,359,59,22,14,0,0,8,9
"E00021592",315,103,35,68,11,148,69,79,53,53,0,0,0,0
"E00021593",225,25,5,20,5,147,24,123,44,40,2,2,0,4
"E00021594",336,108,40,68,3,156,144,12,66,64,0,0,2,3
"E00021595",354,104,56,48,0,178,89,89,70,66,0,4,0,2
"E00021596",381,166,71,95,5,112,102,10,98,84,0,14,0,0
"E00021597",374,119,25,94,0,199,176,23,54,54,0,0,0,2
"E00021598",260,110,37,73,2,9,4,5,132,122,6,4,0,7
"E00021599",326,147,46,101,7,37,9,28,129,119,3,7,0,6
"E00021600",308,168,64,104,4,10,5,5,121,117,0,3,1,5
"E00021601",230,136,57,79,2,2,2,0,87,85,0,0,2,3
"E00021602",368,107,28,79,0,88,76,12,170,168,0,2,0,3
"E00021603",184,85,20,65,2,2,2,0,92,91,0,1,0,3
"E00021604",356,113,34,79,5,149,142,7,84,79,0,5,0,5
"E00021605",289,133,57,76,0,24,22,2,127,118,0,9,0,5
"E00021606",282,144,77,67,1,9,8,1,126,122,1,3,0,2
"E00021607",262,47,13,34,0,168,165,3,42,37,0,5,0,5
"E00021608",217,93,39,54,0,45,13,32,79,78,1,0,0,0
"E00021610",323,109,24,85,1,125,118,7,82,78,0,1,3,6
"E00021611",397,111,23,88,4,171,24,147,108,103,0,5,0,3
"E00021612",214,106,44,62,0,3,0,3,105,98,2,2,3,0
"E00021613",188,86,34,52,0,2,0,2,93,93,0,0,0,7
"E00021614",263,137,40,97,0,0,0,0,115,111,1,1,2,11
"E00021615",218,88,22,66,38,2,2,0,88,86,0,1,1,2
"E00021616",438,105,23,82,3,229,64,165,96,93,0,0,3,5
"E00021617",166,67,32,35,0,4,4,0,91,86,0,5,0,4
"E00021618",282,15,4,11,1,217,88,129,41,34,0,2,5,8
"E00021619",463,111,44,67,0,248,69,179,90,86,0,0,4,14
"E00021620",246,61,19,42,16,91,34,57,76,72,0,4,0,2
"E00021621",333,37,17,20,0,234,34,200,54,47,0,2,5,8
"E00021622",247,97,30,67,0,10,6,4,138,136,0,2,0,2
"E00021623",189,1,0,1,0,157,31,126,31,19,0,0,12,0
"E00021624",292,111,51,60,57,10,4,6,112,108,0,4,0,2
"E00021625",443,197,63,134,1,23,5,18,220,209,1,10,0,2
"E00021626",329,114,69,45,1,43,37,6,168,163,3,1,1,3
"E00021627",372,86,20,66,8,62,39,23,215,199,0,16,0,1
"E00021628",214,81,44,37,0,30,7,23,95,44,40,3,8,8
"E00021629",229,86,27,59,0,28,3,25,106,105,0,1,0,9
"E00021630",262,73,24,49,0,123,118,5,61,60,0,1,0,5
"E00021631",305,131,37,94,2,3,3,0,168,156,0,12,0,1
"E00021632",229,107,40,67,0,15,15,0,105,101,0,4,0,2
"E00021633",214,124,57,67,2,1,0,1,84,82,0,2,0,3
"E00021634",283,125,22,103,1,65,28,37,92,90,0,2,0,0
"E00021635",227,90,35,55,0,8,8,0,127,123,0,4,0,2
"E00021636",335,64,29,35,8,205,103,102,55,51,0,4,0,3
"E00021637",507,63,12,51,58,278,86,192,104,91,0,9,4,4
"E00021639",347,55,12,43,0,205,110,95,79,75,0,4,0,8
"E00021640",397,96,48,48,3,223,65,158,73,65,0,2,6,2
"E00021641",415,35,6,29,17,253,38,215,108,101,0,7,0,2
"E00021642",335,91,30,61,0,144,113,31,94,93,0,1,0,6
"E00021643",246,95,20,75,0,106,81,25,38,33,0,5,0,7
"E00021644",327,50,26,24,0,200,47,153,77,70,0,1,6,0
"E00021646",498,131,46,85,31,238,99,139,97,92,0,2,3,1
"E00021648",202,72,16,56,18,9,0,9,101,89,0,12,0,2
"E00021649",434,103,40,63,0,221,206,15,106,104,0,2,0,4
"E00021650",265,71,13,58,0,96,9,87,91,84,0,7,0,7
"E00021651",251,104,34,70,0,6,0,6,136,134,0,2,0,5
"E00021652",276,125,36,89,2,6,6,0,139,132,2,5,0,4
"E00021653",547,95,24,71,3,313,265,48,124,118,0,6,0,12
"E00021654",379,2,0,2,0,325,34,291,47,47,0,0,0,5
"E00021655",274,85,26,59,0,129,114,15,54,47,0,0,7,6
"E00021656",386,108,46,62,4,130,44,86,128,113,0,2,13,16
"E00021657",204,86,23,63,0,6,5,1,106,101,0,3,2,6
"E00021658",177,102,38,64,0,3,0,3,71,63,0,5,3,1
"E00021659",335,22,9,13,18,193,13,180,100,98,0,2,0,2
"E00021660",278,64,25,39,44,95,91,4,73,73,0,0,0,2
"E00021661",480,77,49,28,0,224,94,130,170,152,0,3,15,9
"E00021662",566,64,8,56,4,355,81,274,131,128,0,0,3,12
"E00021663",236,10,4,6,7,210,51,159,3,3,0,0,0,6
"E00021665",473,121,40,81,0,238,213,25,105,92,0,5,8,9
"E00021666",559,82,21,61,0,285,65,220,181,176,2,3,0,11
"E00021667",490,152,26,126,1,211,182,29,115,110,0,5,0,11
"E00021668",499,110,18,92,7,249,94,155,130,129,0,1,0,3
"E00021669",488,103,17,86,6,282,162,120,88,88,0,0,0,9
"E00021670",402,70,10,60,9,219,71,148,95,95,0,0,0,9
"E00021671",351,112,26,86,1,166,141,25,58,56,0,2,0,14
"E00021672",416,74,41,33,7,195,64,131,135,132,0,3,0,5
"E00021673",374,3,0,3,2,303,11,292,62,54,0,0,8,4
"E00021674",378,121,33,88,1,85,29,56,168,162,0,6,0,3
"E00021675",518,92,23,69,0,353,318,35,72,70,0,0,2,1
"E00021676",293,69,17,52,6,9,2,7,206,195,1,10,0,3
"E00021677",336,64,17,47,1,193,47,146,76,74,0,1,1,2
"E00021678",438,217,59,158,0,91,47,44,123,119,0,4,0,7
"E00021679",150,55,9,46,3,56,41,15,36,30,0,6,0,0
"E00021680",494,199,99,100,1,142,8,134,139,130,0,4,5,13
"E00021681",262,93,43,50,2,27,2,25,140,139,0,1,0,0
"E00021682",545,194,50,144,0,201,185,16,146,146,0,0,0,4
"E00021683",509,132,45,87,0,241,155,86,117,114,0,1,2,19
"E00021685",568,141,32,109,9,228,92,136,187,169,0,13,5,3
"E00021686",330,112,42,70,3,68,23,45,141,123,0,5,13,6
"E00021687",435,110,36,74,2,82,63,19,239,225,0,11,3,2
"E00021688",381,115,37,78,6,141,83,58,112,102,0,3,7,7
"E00021689",271,68,17,51,1,15,1,14,184,182,0,2,0,3
"E00021690",445,92,26,66,1,126,41,85,226,202,1,3,20,0
"E00021691",315,51,24,27,0,165,59,106,97,76,2,2,17,2
"E00021692",271,72,35,37,0,50,2,48,145,139,0,2,4,4
"E00021693",430,94,30,64,0,153,55,98,179,171,0,8,0,4
"E00021694",454,85,19,66,3,198,39,159,155,141,0,3,11,13
"E00021695",372,117,41,76,2,101,45,56,151,140,0,11,0,1
"E00021696",522,117,26,91,10,285,37,248,108,99,0,4,5,2
"E00021697",305,48,14,34,19,169,166,3,69,66,0,3,0,0
"E00021698",340,186,78,108,0,44,9,35,103,84,0,19,0,7
"E00021699",390,72,36,36,2,227,79,148,84,74,0,4,6,5
"E00021700",511,145,40,105,3,195,150,45,164,158,2,4,0,4
"E00021701",442,164,41,123,8,112,86,26,148,130,0,18,0,10
"E00021702",370,40,29,11,0,260,235,25,55,55,0,0,0,15
"E00021703",315,72,23,49,2,156,135,21,84,82,0,0,2,1
"E00021704",375,50,13,37,4,179,146,33,135,133,0,2,0,7
"E00021705",431,130,51,79,13,176,158,18,112,100,0,3,9,0
"E00021706",338,82,35,47,6,148,146,2,89,89,0,0,0,13
"E00021707",377,60,6,54,0,221,182,39,95,94,0,0,1,1
"E00021708",298,75,19,56,4,132,115,17,86,78,0,8,0,1
"E00021709",324,30,9,21,0,185,173,12,109,106,0,3,0,0
"E00021710",313,83,29,54,0,170,159,11,58,54,0,4,0,2
"E00021711",471,85,23,62,0,145,120,25,238,231,3,4,0,3
"E00021712",297,73,30,43,0,74,50,24,148,145,0,0,3,2
"E00021713",295,24,6,18,0,196,173,23,62,62,0,0,0,13
"E00021714",209,45,12,33,5,141,113,28,18,18,0,0,0,0
"E00021715",357,49,17,32,0,221,174,47,81,80,0,1,0,6
"E00021716",280,40,14,26,0,193,186,7,46,40,0,2,4,1
"E00021717",253,43,23,20,0,154,134,20,53,53,0,0,0,3
"E00021718",361,102,21,81,3,124,112,12,128,125,0,3,0,4
"E00021719",163,47,15,32,0,83,74,9,33,31,0,2,0,0
"E00021722",342,12,5,7,0,211,24,187,110,101,0,0,9,9
"E00021723",269,63,17,46,1,123,70,53,78,64,2,12,0,4
"E00021724",260,149,63,86,0,14,5,9,93,86,0,4,3,4
"E00021725",232,123,54,69,0,38,3,35,71,67,0,0,4,0
"E00021726",268,46,13,33,0,190,187,3,32,32,0,0,0,0
"E00021727",249,14,3,11,0,218,50,168,15,12,1,2,0,2
"E00021728",253,54,18,36,1,131,124,7,57,55,0,2,0,10
"E00021729",190,39,8,31,2,101,99,2,48,44,0,4,0,0
"E00021730",370,80,24,56,2,219,213,6,68,64,0,0,4,1
"E00021731",396,79,19,60,10,246,209,37,59,56,0,3,0,2
"E00021732",268,90,22,68,0,90,82,8,88,80,0,4,4,0
"E00021733",525,109,43,66,4,280,30,250,132,98,13,8,13,0
"E00021734",599,116,34,82,32,357,167,190,91,76,0,11,4,3
"E00021735",481,80,33,47,0,258,82,176,142,139,1,0,2,1
"E00021736",492,135,50,85,5,232,226,6,112,106,0,0,6,8
"E00021737",283,78,13,65,5,103,60,43,89,83,0,3,3,8
"E00021738",332,18,7,11,1,271,22,249,42,39,2,0,1,0
"E00021739",273,30,10,20,0,14,8,6,229,222,0,7,0,0
"E00021740",393,65,21,44,33,226,197,29,66,66,0,0,0,3
"E00021741",223,44,14,30,0,5,0,5,173,168,0,4,1,1
"E00021742",547,46,27,19,1,137,43,94,357,355,0,0,2,6
"E00021743",313,21,15,6,0,147,41,106,141,139,0,0,2,4
"E00021744",568,82,14,68,0,129,56,73,347,342,0,0,5,10
"E00021745",233,47,12,35,0,135,124,11,51,47,0,4,0,0
"E00021746",233,48,7,41,13,2,0,2,166,164,0,2,0,4
"E00021748",534,143,70,73,6,145,132,13,234,222,0,12,0,6
"E00021750",449,128,63,65,0,173,158,15,145,145,0,0,0,3
"E00021752",422,93,39,54,1,197,187,10,127,127,0,0,0,4
"E00021753",282,40,19,21,0,201,125,76,41,40,0,1,0,0
"E00021754",204,35,11,24,0,109,107,2,60,57,0,0,3,0
"E00021755",358,156,30,126,0,104,44,60,94,88,0,6,0,4
"E00021756",217,50,3,47,5,83,55,28,77,62,0,6,9,2
"E00021757",248,44,12,32,0,167,164,3,33,31,0,1,1,4
"E00021758",322,47,18,29,0,160,49,111,112,105,0,5,2,3
"E00021759",369,105,26,79,0,188,170,18,69,67,0,2,0,7
"E00021760",351,89,18,71,0,205,190,15,54,54,0,0,0,3
"E00021761",209,37,19,18,6,41,2,39,120,102,7,0,11,5
"E00021762",306,67,13,54,0,115,106,9,119,105,0,3,11,5
"E00021763",394,112,44,68,0,192,135,57,87,84,0,3,0,3
"E00021764",467,142,43,99,2,140,57,83,166,166,0,0,0,17
"E00021766",413,38,22,16,0,268,36,232,91,88,3,0,0,16
"E00021767",233,64,20,44,0,81,72,9,84,84,0,0,0,4
"E00167078",270,42,22,20,0,57,49,8,170,164,0,2,4,1
"E00167079",222,31,4,27,2,16,0,16,169,169,0,0,0,4
"E00167080",390,78,30,48,23,189,14,175,97,97,0,0,0,3
"E00167081",279,114,36,78,0,14,0,14,141,138,0,3,0,10
"E00167082",309,55,12,43,28,39,8,31,185,164,0,21,0,2
"E00167083",343,29,8,21,8,195,26,169,103,101,0,2,0,8
"E00167084",231,21,8,13,42,55,10,45,111,111,0,0,0,2
"E00167085",267,55,25,30,0,97,36,61,114,107,0,6,1,1
"E00167086",368,102,33,69,5,125,82,43,136,134,0,2,0,0
"E00167087",282,71,8,63,9,44,19,25,158,158,0,0,0,0
"E00167088",210,55,5,50,1,29,15,14,120,117,0,3,0,5
"E00167089",171,20,8,12,2,39,0,39,107,104,0,3,0,3
"E00167090",195,3,0,3,13,148,7,141,24,24,0,0,0,7
"E00167091",331,60,6,54,22,90,3,87,154,143,2,9,0,5
"E00167092",294,49,19,30,35,96,19,77,109,106,0,3,0,5
"E00167093",196,33,8,25,6,51,3,48,106,102,1,3,0,0
"E00167094",280,69,32,37,2,52,3,49,148,146,0,2,0,9
"E00167095",286,89,18,71,6,109,55,54,82,81,0,1,0,0
"E00167096",131,35,4,31,0,2,1,1,94,91,0,3,0,0
"E00167097",259,31,13,18,55,78,32,46,86,85,1,0,0,9
"E00167098",131,8,1,7,3,7,2,5,113,113,0,0,0,0
"E00167099",110,25,16,9,0,4,2,2,81,77,0,3,1,0
"E00167100",519,60,26,34,0,4,0,4,452,441,0,6,5,3
"E00167101",256,100,32,68,0,6,0,6,140,136,0,2,2,10
"E00167102",300,14,0,14,8,119,38,81,150,150,0,0,0,9
"E00167103",206,57,11,46,0,3,3,0,144,139,0,5,0,2
"E00167104",216,96,32,64,4,5,0,5,111,107,0,4,0,0
"E00167105",479,70,4,66,21,347,68,279,26,20,0,5,1,15
"E00167106",314,149,36,113,11,14,0,14,132,126,0,6,0,8
"E00167107",238,39,5,34,9,106,6,100,83,80,0,0,3,1
"E00167108",400,89,32,57,26,190,37,153,92,82,0,8,2,3
"E00167109",261,44,14,30,0,100,22,78,115,112,1,2,0,2
"E00167110",293,73,22,51,0,102,33,69,113,112,1,0,0,5
"E00167111",282,37,12,25,4,4,0,4,237,232,0,0,5,0
"E00167112",795,154,34,120,5,167,40,127,433,406,19,3,5,36
"E00167113",473,22,7,15,49,315,47,268,84,70,1,0,13,3
"E00167114",464,81,31,50,0,282,52,230,100,94,0,6,0,1
"E00167115",727,83,37,46,27,259,46,213,344,337,3,2,2,14
"E00167116",280,59,27,32,0,183,18,165,31,28,0,3,0,7
"E00167117",133,52,10,42,2,11,4,7,52,52,0,0,0,16
"E00167118",244,70,15,55,0,11,4,7,159,154,0,4,1,4
"E00167119",305,96,17,79,6,79,45,34,118,115,1,1,1,6
"E00167120",283,24,6,18,24,109,31,78,111,105,2,4,0,15
"E00167121",265,75,29,46,0,15,1,14,172,165,5,2,0,3
"E00167122",202,50,27,23,0,27,4,23,123,121,1,0,1,2
"E00167123",347,22,6,16,30,270,31,239,22,22,0,0,0,3
"E00167124",308,38,2,36,68,158,9,149,44,38,0,4,2,0
"E00167125",173,53,10,43,2,13,0,13,104,101,0,3,0,1
"E00167126",367,106,26,80,0,15,6,9,243,235,0,7,1,3
"E00167127",265,91,33,58,0,22,12,10,146,138,3,2,3,6
"E00167128",276,14,4,10,35,183,47,136,40,40,0,0,0,4
"E00167129",615,95,19,76,6,180,24,156,331,322,1,7,1,3
"E00167130",834,249,51,198,39,289,26,263,244,235,0,4,5,13
"E00167131",145,10,1,9,0,91,2,89,32,31,0,0,1,12
"E00167132",393,47,15,32,22,5,1,4,314,305,0,9,0,5
"E00167133",175,49,17,32,0,66,23,43,59,55,0,4,0,1
"E00167134",222,116,33,83,0,5,0,5,98,91,0,5,2,3
"E00167135",269,106,36,70,1,9,3,6,149,146,0,3,0,4
"E00167136",178,26,5,21,0,100,26,74,52,52,0,0,0,0
"E00167137",222,47,16,31,5,12,4,8,156,153,0,0,3,2
"E00167138",230,28,7,21,11,68,2,66,120,120,0,0,0,3
"E00167139",305,35,14,21,2,18,8,10,250,246,2,2,0,0
"E00167140",246,13,3,10,13,75,18,57,143,139,0,4,0,2
"E00167141",313,102,22,80,0,11,0,11,200,200,0,0,0,0
"E00167142",453,199,70,129,3,15,8,7,235,230,0,3,2,1
"E00167143",337,47,31,16,13,174,157,17,103,99,0,4,0,0
"E00167144",428,53,26,27,1,339,286,53,35,32,0,2,1,0
"E00167145",196,41,11,30,0,10,0,10,141,133,0,2,6,4
"E00167146",300,93,15,78,1,15,9,6,186,174,0,11,1,5
"E00167147",277,9,4,5,13,200,10,190,53,50,0,2,1,2
"E00167148",188,27,10,17,0,2,0,2,157,156,0,1,0,2
"E00167149",167,27,0,27,11,40,0,40,87,83,0,4,0,2
"E00167150",366,62,9,53,32,76,12,64,194,187,0,3,4,2
"E00167151",423,71,24,47,5,13,4,9,327,320,0,7,0,7
"E00167152",164,36,20,16,7,5,0,5,116,114,0,2,0,0
"E00167153",402,25,8,17,2,295,63,232,70,67,1,2,0,10
"E00167154",205,66,30,36,0,7,0,7,131,127,0,2,2,1
"E00167155",310,76,17,59,8,28,0,28,192,176,7,4,5,6
"E00167156",336,30,12,18,0,220,145,75,84,76,0,8,0,2
"E00167157",317,78,26,52,0,2,0,2,234,228,0,6,0,3
"E00167158",257,63,19,44,0,5,0,5,188,187,0,0,1,1
"E00167159",211,93,45,48,0,3,0,3,112,111,0,0,1,3
"E00167160",316,44,21,23,8,180,9,171,81,79,0,2,0,3
"E00167161",312,49,15,34,7,206,73,133,50,50,0,0,0,0
"E00167162",337,69,8,61,0,22,15,7,244,243,0,1,0,2
"E00167163",260,57,18,39,21,4,0,4,176,165,0,6,5,2
"E00167164",118,16,3,13,18,60,16,44,24,24,0,0,0,0
"E00167165",228,77,23,54,4,1,1,0,143,141,1,1,0,3
"E00167166",464,21,6,15,14,64,9,55,365,352,5,3,5,0
"E00167167",267,41,23,18,2,6,0,6,218,211,0,5,2,0
"E00167168",281,86,18,68,5,69,4,65,116,114,0,2,0,5
"E00167169",282,7,4,3,22,190,27,163,63,60,0,0,3,0
"E00167170",171,75,19,56,0,10,6,4,85,85,0,0,0,1
"E00167171",211,40,11,29,0,105,93,12,66,66,0,0,0,0
"E00167172",174,48,14,34,9,14,1,13,99,94,0,5,0,4
"E00167173",473,36,4,32,10,387,67,320,17,17,0,0,0,23
"E00167174",240,127,56,71,1,9,9,0,101,99,0,0,2,2
"E00167175",212,141,94,47,1,0,0,0,67,62,0,4,1,3
"E00167176",332,36,19,17,1,120,10,110,168,163,0,5,0,7
"E00167177",264,54,23,31,2,6,1,5,202,193,0,6,3,0
"E00167178",321,39,10,29,9,158,17,141,114,105,0,9,0,1
"E00167179",240,12,4,8,1,18,11,7,209,208,0,0,1,0
"E00167180",311,15,3,12,56,206,28,178,29,24,0,2,3,5
"E00167181",160,26,3,23,7,51,25,26,76,76,0,0,0,0
"E00167182",149,18,1,17,13,102,8,94,15,10,0,0,5,1
"E00167183",139,89,54,35,0,2,0,2,46,44,0,0,2,2
"E00167184",175,20,7,13,13,94,41,53,45,43,0,2,0,3
"E00167185",247,3,0,3,2,222,21,201,19,19,0,0,0,1
"E00167186",243,69,12,57,2,19,0,19,153,149,0,4,0,0
"E00167187",288,82,25,57,0,73,68,5,132,126,0,1,5,1
"E00167188",304,85,21,64,1,6,4,2,212,210,0,2,0,0
"E00167189",273,44,7,37,3,87,14,73,136,136,0,0,0,3
"E00167190",210,39,13,26,2,70,8,62,98,90,0,8,0,1
"E00167191",216,64,4,60,0,21,5,16,131,128,0,2,1,0
"E00167192",230,43,5,38,6,70,18,52,111,108,0,3,0,0
"E00167193",220,19,5,14,0,178,13,165,23,18,0,5,0,0
"E00167194",287,30,7,23,47,144,5,139,55,49,0,6,0,11
"E00167195",189,54,12,42,5,52,0,52,74,72,0,1,1,4
"E00167196",204,11,7,4,0,183,19,164,3,3,0,0,0,7
"E00167197",246,23,4,19,2,160,10,150,58,52,0,0,6,3
"E00167198",535,93,44,49,37,270,49,221,133,133,0,0,0,2
"E00167199",171,26,0,26,0,27,8,19,118,114,0,4,0,0
"E00167200",218,20,3,17,0,14,2,12,184,184,0,0,0,0
"E00167201",319,19,5,14,0,273,26,247,27,25,0,2,0,0
"E00167202",197,30,14,16,0,149,37,112,16,16,0,0,0,2
"E00167203",384,52,6,46,0,219,27,192,113,101,0,6,6,0
"E00167204",239,127,16,111,0,9,1,8,103,95,0,8,0,0
"E00167205",326,49,7,42,12,211,177,34,54,35,0,7,12,0
"E00167206",387,65,26,39,1,243,233,10,77,77,0,0,0,1
"E00167207",335,78,32,46,34,148,39,109,75,68,0,7,0,0
"E00167208",266,127,29,98,2,12,7,5,122,120,0,2,0,3
"E00167209",376,6,0,6,79,246,13,233,45,39,0,0,6,0
"E00167210",141,69,9,60,0,7,7,0,64,58,0,6,0,1
"E00167211",378,64,13,51,1,128,71,57,170,166,0,0,4,15
"E00167212",282,49,7,42,6,195,79,116,29,26,0,0,3,3
"E00167213",397,57,8,49,0,259,102,157,52,41,0,0,11,29
"E00167214",362,48,21,27,1,159,57,102,152,149,0,3,0,2
"E00167215",327,66,13,53,5,136,27,109,110,105,0,1,4,10
"E00167216",379,44,16,28,16,225,90,135,81,76,0,5,0,13
"E00167217",278,37,9,28,0,185,79,106,55,55,0,0,0,1
"E00167218",303,66,16,50,9,167,31,136,53,52,0,0,1,8
"E00167219",307,22,0,22,1,246,82,164,36,32,0,0,4,2
"E00167220",228,61,24,37,8,9,0,9,149,147,0,0,2,1
"E00167221",419,93,18,75,6,215,153,62,90,90,0,0,0,15
"E00167222",322,101,23,78,2,125,118,7,89,89,0,0,0,5
"E00167223",393,15,7,8,45,313,7,306,20,20,0,0,0,0
"E00167224",351,6,1,5,16,293,30,263,35,35,0,0,0,1
"E00167225",402,11,2,9,26,333,32,301,32,28,0,0,4,0
"E00167226",226,35,9,26,85,56,4,52,50,49,0,1,0,0
"E00167227",336,68,12,56,3,135,45,90,130,126,0,3,1,0
"E00167228",292,27,5,22,24,201,40,161,39,37,0,1,1,1
"E00167229",341,39,5,34,3,239,92,147,55,55,0,0,0,5
"E00167230",196,36,7,29,16,12,7,5,132,132,0,0,0,0
"E00167231",260,34,1,33,6,106,40,66,114,113,0,0,1,0
"E00167232",200,52,10,42,14,27,6,21,105,96,0,9,0,2
"E00167233",213,31,14,17,63,105,24,81,14,14,0,0,0,0
"E00167234",378,56,9,47,13,254,79,175,47,42,0,0,5,8
"E00167235",462,77,13,64,8,256,149,107,98,92,0,3,3,23
"E00167236",180,20,4,16,0,2,2,0,158,151,0,2,5,0
"E00167237",192,89,18,71,0,4,0,4,99,99,0,0,0,0
"E00167238",349,25,11,14,25,273,108,165,23,14,0,2,7,3
"E00167239",188,8,6,2,59,102,8,94,19,18,0,0,1,0
"E00167240",481,13,2,11,0,432,66,366,26,16,0,0,10,10
"E00167241",380,59,6,53,12,209,190,19,86,86,0,0,0,14
"E00167242",191,16,1,15,79,49,5,44,47,45,0,1,1,0
"E00167243",283,55,19,36,4,30,10,20,193,183,0,10,0,1
"E00167244",255,41,23,18,4,14,2,12,196,196,0,0,0,0
"E00167245",302,60,16,44,2,146,23,123,92,78,0,14,0,2
"E00167246",226,29,16,13,8,170,12,158,19,18,0,1,0,0
"E00167247",171,76,21,55,0,36,5,31,59,53,0,6,0,0
"E00167248",369,61,10,51,40,21,11,10,242,241,0,1,0,5
"E00167249",352,53,20,33,6,22,3,19,266,265,0,0,1,5
"E00167250",428,11,4,7,6,371,57,314,30,30,0,0,0,10
"E00167251",309,8,2,6,0,50,1,49,251,70,0,0,181,0
"E00167252",381,45,5,40,42,212,97,115,79,75,3,1,0,3
"E00167253",310,10,0,10,31,238,16,222,31,29,0,2,0,0
"E00167254",254,51,28,23,0,92,72,20,109,78,0,6,25,2
"E00167255",382,41,11,30,52,258,13,245,21,18,0,0,3,10
"E00167256",280,4,0,4,82,176,5,171,18,16,0,0,2,0
"E00167257",367,21,4,17,140,184,16,168,22,20,0,2,0,0
"E00167258",393,26,1,25,0,352,34,318,5,5,0,0,0,10
"E00167259",255,5,0,5,8,205,22,183,36,36,0,0,0,1
"E00167260",474,31,6,25,0,375,32,343,57,52,0,4,1,11
"E00167261",401,128,46,82,5,112,17,95,154,128,2,24,0,2
"E00167262",91,47,19,28,0,3,0,3,41,41,0,0,0,0
"E00167263",192,54,15,39,3,4,0,4,131,127,0,4,0,0
"E00167264",287,43,11,32,51,148,19,129,43,40,0,2,1,2
"E00167265",328,99,31,68,0,121,117,4,104,93,0,5,6,4
"E00167266",315,73,15,58,1,124,54,70,109,107,0,2,0,8
